"Czas","Data","Godzina","Al. USA - suma","Al. USA - południe","Al. USA - północ","Banacha","Bazyliańska","Belwederska","Dworzec Wilenski (al. Solidarności)","Dworzec Wileński (Targowa)","Marszałkowska","Most Gdański - suma","Most Gdański - ciąg pieszo-rowerowy","Most Gdanski - ścieżka rowerowa","NSR - Solec - suma","NSR - Solec - ciąg pieszo-rowerowy","NSR-Solec - ścieżka rowerowa","Praska ścieżka rekreacyjna","Świętokrzyska - Emilii Plater - suma","Świętokrzyska - Emilii Plater, płd","Świętokrzyska - Emilii Plater, płn","Wybrzeże Helskie","Wysockiego","Żwirki i Wigury/Trojdena - suma","Żwirki i Wigury/Trojdena zach.","Żwirki i Wigury/Trojdena wsch.","Jaki_dzien"
2017-05-08 00:00:00,2017-05-08,0,3,0,3,5,0,2,1,2,1,3,0,3,1,0,1,0,2,2,0,3,1,0,0,0,"roboczy"
2017-05-08 01:00:00,2017-05-08,1,0,0,0,2,0,1,0,0,0,0,0,0,0,0,0,0,2,0,2,0,0,0,0,0,"roboczy"
2017-05-08 02:00:00,2017-05-08,2,0,0,0,0,0,0,1,0,0,0,0,0,0,0,0,0,1,1,0,0,0,0,0,0,"roboczy"
2017-05-08 03:00:00,2017-05-08,3,0,0,0,2,0,2,1,1,0,0,0,0,0,0,0,0,1,0,1,1,0,1,0,1,"roboczy"
2017-05-08 04:00:00,2017-05-08,4,1,1,0,1,0,0,0,1,0,1,0,1,0,0,0,0,1,1,0,2,2,0,0,0,"roboczy"
2017-05-08 05:00:00,2017-05-08,5,5,3,2,3,0,2,2,3,4,5,1,4,1,0,1,3,11,9,2,6,2,6,2,4,"roboczy"
2017-05-08 06:00:00,2017-05-08,6,13,11,2,40,4,11,26,13,15,26,6,20,20,1,19,0,36,25,11,28,11,24,5,19,"roboczy"
2017-05-08 07:00:00,2017-05-08,7,35,20,15,141,13,30,66,37,31,79,17,62,52,10,42,1,140,78,62,72,16,107,27,80,"roboczy"
2017-05-08 08:00:00,2017-05-08,8,34,21,13,228,8,67,54,33,62,46,15,31,57,6,51,1,240,112,128,78,11,130,38,92,"roboczy"
2017-05-08 09:00:00,2017-05-08,9,27,16,11,128,3,40,32,17,37,40,9,31,24,5,19,2,160,87,73,42,9,60,17,43,"roboczy"
2017-05-08 10:00:00,2017-05-08,10,13,8,5,69,3,20,28,31,29,15,4,11,19,2,17,1,89,47,42,25,6,59,22,37,"roboczy"
2017-05-08 11:00:00,2017-05-08,11,22,17,5,50,2,14,22,17,34,22,8,14,13,5,8,0,100,60,40,20,6,43,19,24,"roboczy"
2017-05-08 12:00:00,2017-05-08,12,14,10,4,65,3,25,32,35,25,22,11,11,20,4,16,1,85,48,37,18,10,34,10,24,"roboczy"
2017-05-08 13:00:00,2017-05-08,13,12,7,5,72,2,29,17,31,50,34,12,22,26,5,21,2,124,74,50,39,10,60,27,33,"roboczy"
2017-05-08 14:00:00,2017-05-08,14,23,16,7,77,1,22,23,34,34,32,13,19,18,7,11,1,91,49,42,33,15,60,12,48,"roboczy"
2017-05-08 15:00:00,2017-05-08,15,38,25,13,92,7,33,44,47,52,50,26,24,44,11,33,1,122,78,44,54,13,74,13,61,"roboczy"
2017-05-08 16:00:00,2017-05-08,16,38,21,17,196,8,82,48,50,60,116,78,38,74,19,55,1,232,132,100,82,23,128,21,107,"roboczy"
2017-05-08 17:00:00,2017-05-08,17,41,30,11,193,5,73,60,45,46,135,84,51,69,17,52,4,233,133,100,89,24,137,30,107,"roboczy"
2017-05-08 18:00:00,2017-05-08,18,37,24,13,124,5,52,36,37,32,91,55,36,37,7,30,2,147,73,74,48,15,96,22,74,"roboczy"
2017-05-08 19:00:00,2017-05-08,19,28,15,13,75,4,25,28,28,30,34,8,26,26,7,19,0,126,70,56,39,11,42,12,30,"roboczy"
2017-05-08 20:00:00,2017-05-08,20,13,5,8,41,3,21,26,18,17,14,3,11,13,3,10,0,73,37,36,30,11,29,12,17,"roboczy"
2017-05-08 21:00:00,2017-05-08,21,11,9,2,29,3,14,9,14,15,18,5,13,11,2,9,1,60,33,27,23,6,22,6,16,"roboczy"
2017-05-08 22:00:00,2017-05-08,22,5,4,1,14,2,9,7,10,10,11,2,9,11,1,10,0,45,34,11,12,3,9,5,4,"roboczy"
2017-05-08 23:00:00,2017-05-08,23,0,0,0,6,1,7,5,6,4,7,1,6,6,2,4,0,18,12,6,2,2,9,3,6,"roboczy"
2017-05-09 00:00:00,2017-05-09,0,1,0,1,2,1,1,2,2,7,1,1,0,1,0,1,0,8,6,2,1,1,1,0,1,"roboczy"
2017-05-09 01:00:00,2017-05-09,1,1,0,1,1,0,1,2,0,2,1,1,0,0,0,0,0,4,3,1,1,0,1,0,1,"roboczy"
2017-05-09 02:00:00,2017-05-09,2,1,1,0,2,0,0,0,0,1,0,0,0,0,0,0,0,5,4,1,0,1,0,0,0,"roboczy"
2017-05-09 03:00:00,2017-05-09,3,0,0,0,1,0,1,1,1,0,0,0,0,0,0,0,0,0,0,0,0,0,0,0,0,"roboczy"
2017-05-09 04:00:00,2017-05-09,4,2,1,1,1,0,0,1,2,2,1,0,1,0,0,0,0,4,2,2,4,3,1,0,1,"roboczy"
2017-05-09 05:00:00,2017-05-09,5,3,3,0,7,4,2,3,3,5,6,2,4,5,0,5,0,12,3,9,16,7,8,1,7,"roboczy"
2017-05-09 06:00:00,2017-05-09,6,19,16,3,46,3,7,29,17,13,30,11,19,25,5,20,0,50,28,22,37,8,32,9,23,"roboczy"
2017-05-09 07:00:00,2017-05-09,7,35,24,11,165,12,42,76,45,40,71,23,48,55,12,43,0,163,89,74,78,11,126,27,99,"roboczy"
2017-05-09 08:00:00,2017-05-09,8,35,21,14,244,5,69,46,49,66,69,22,47,59,11,48,4,241,123,118,70,12,154,35,119,"roboczy"
2017-05-09 09:00:00,2017-05-09,9,22,18,4,123,2,37,35,23,45,37,14,23,35,9,26,2,141,58,83,51,8,75,18,57,"roboczy"
2017-05-09 10:00:00,2017-05-09,10,12,6,6,77,3,21,24,21,35,35,17,18,20,5,15,3,87,45,42,26,11,50,15,35,"roboczy"
2017-05-09 11:00:00,2017-05-09,11,14,6,8,77,4,20,21,30,36,35,22,13,15,7,8,3,117,55,62,26,7,48,11,37,"roboczy"
2017-05-09 12:00:00,2017-05-09,12,19,13,6,86,3,13,27,24,39,34,17,17,29,13,16,7,100,49,51,28,10,56,24,32,"roboczy"
2017-05-09 13:00:00,2017-05-09,13,27,19,8,94,1,40,26,36,55,48,23,25,41,13,28,3,118,68,50,37,10,59,27,32,"roboczy"
2017-05-09 14:00:00,2017-05-09,14,27,18,9,94,4,41,27,33,56,64,34,30,35,11,24,8,121,63,58,53,11,53,15,38,"roboczy"
2017-05-09 15:00:00,2017-05-09,15,38,23,15,120,4,52,41,43,85,94,55,39,53,15,38,7,176,100,76,67,17,108,35,73,"roboczy"
2017-05-09 16:00:00,2017-05-09,16,53,36,17,255,5,89,66,46,76,229,145,84,90,28,62,11,301,171,130,101,17,154,28,126,"roboczy"
2017-05-09 17:00:00,2017-05-09,17,47,34,13,264,9,93,70,65,74,187,134,53,80,23,57,14,299,161,138,99,22,198,42,156,"roboczy"
2017-05-09 18:00:00,2017-05-09,18,40,32,8,167,4,91,53,38,53,83,42,41,49,9,40,15,208,118,90,56,13,124,22,102,"roboczy"
2017-05-09 19:00:00,2017-05-09,19,24,15,9,106,7,39,45,35,35,53,16,37,34,6,28,7,146,83,63,55,14,74,19,55,"roboczy"
2017-05-09 20:00:00,2017-05-09,20,18,15,3,74,2,24,17,22,21,33,13,20,38,9,29,2,85,52,33,34,11,61,27,34,"roboczy"
2017-05-09 21:00:00,2017-05-09,21,16,10,6,27,2,15,10,28,15,28,9,19,26,6,20,1,59,37,22,18,6,20,13,7,"roboczy"
2017-05-09 22:00:00,2017-05-09,22,5,5,0,26,2,8,7,8,13,8,3,5,7,1,6,0,47,34,13,19,6,19,8,11,"roboczy"
2017-05-09 23:00:00,2017-05-09,23,7,6,1,10,0,11,3,5,11,1,1,0,2,0,2,0,25,18,7,6,4,7,3,4,"roboczy"
2017-05-10 00:00:00,2017-05-10,0,3,2,1,3,0,8,3,2,5,0,0,0,0,0,0,0,8,5,3,5,1,4,2,2,"roboczy"
2017-05-10 01:00:00,2017-05-10,1,2,0,2,3,0,1,0,0,2,1,1,0,1,0,1,0,4,3,1,0,1,0,0,0,"roboczy"
2017-05-10 02:00:00,2017-05-10,2,0,0,0,5,0,0,0,0,2,1,1,0,0,0,0,0,4,3,1,0,0,2,1,1,"roboczy"
2017-05-10 03:00:00,2017-05-10,3,2,2,0,0,0,1,1,1,0,0,0,0,0,0,0,1,1,0,1,3,0,0,0,0,"roboczy"
2017-05-10 04:00:00,2017-05-10,4,1,1,0,2,0,0,2,5,0,3,0,3,1,0,1,0,2,1,1,6,1,0,0,0,"roboczy"
2017-05-10 05:00:00,2017-05-10,5,5,3,2,7,4,2,5,8,4,8,3,5,4,2,2,0,8,2,6,12,6,7,2,5,"roboczy"
2017-05-10 06:00:00,2017-05-10,6,10,9,1,49,3,9,23,24,12,22,9,13,26,4,22,1,43,22,21,38,12,45,13,32,"roboczy"
2017-05-10 07:00:00,2017-05-10,7,45,25,20,187,11,38,68,37,41,58,17,41,48,6,42,2,163,88,75,81,15,116,30,86,"roboczy"
2017-05-10 08:00:00,2017-05-10,8,22,15,7,226,4,69,47,56,65,54,12,42,59,10,49,3,236,124,112,75,11,152,33,119,"roboczy"
2017-05-10 09:00:00,2017-05-10,9,21,10,11,129,4,41,32,33,35,37,8,29,32,6,26,3,171,79,92,35,8,81,16,65,"roboczy"
2017-05-10 10:00:00,2017-05-10,10,16,12,4,87,4,24,25,28,28,26,10,16,28,6,22,1,105,51,54,42,10,48,13,35,"roboczy"
2017-05-10 11:00:00,2017-05-10,11,28,14,14,77,5,26,17,19,27,30,11,19,25,7,18,4,121,52,69,30,13,54,18,36,"roboczy"
2017-05-10 12:00:00,2017-05-10,12,19,9,10,102,3,24,32,26,33,30,12,18,33,9,24,10,120,57,63,41,8,68,27,41,"roboczy"
2017-05-10 13:00:00,2017-05-10,13,21,12,9,84,7,25,24,31,41,33,13,20,34,9,25,7,127,62,65,49,13,70,29,41,"roboczy"
2017-05-10 14:00:00,2017-05-10,14,30,18,12,84,6,34,35,37,49,53,21,32,40,10,30,8,151,100,51,50,14,68,22,46,"roboczy"
2017-05-10 15:00:00,2017-05-10,15,34,22,12,132,10,43,49,54,64,80,35,45,59,12,47,16,180,88,92,74,24,82,20,62,"roboczy"
2017-05-10 16:00:00,2017-05-10,16,42,28,14,242,10,98,83,69,89,142,76,66,76,19,57,12,298,175,123,115,26,152,24,128,"roboczy"
2017-05-10 17:00:00,2017-05-10,17,47,34,13,203,5,94,62,58,65,189,111,78,71,15,56,9,255,139,116,72,22,149,26,123,"roboczy"
2017-05-10 18:00:00,2017-05-10,18,25,19,6,119,3,76,33,23,43,72,48,24,39,13,26,3,168,78,90,55,18,75,16,59,"roboczy"
2017-05-10 19:00:00,2017-05-10,19,10,3,7,80,5,24,37,37,29,52,20,32,33,4,29,4,118,65,53,56,11,66,15,51,"roboczy"
2017-05-10 20:00:00,2017-05-10,20,12,5,7,62,4,23,20,25,32,31,10,21,19,8,11,1,98,62,36,49,8,39,14,25,"roboczy"
2017-05-10 21:00:00,2017-05-10,21,24,16,8,33,2,17,16,23,23,19,3,16,13,2,11,1,78,52,26,26,6,30,9,21,"roboczy"
2017-05-10 22:00:00,2017-05-10,22,5,2,3,21,0,8,10,4,19,16,5,11,15,1,14,0,52,38,14,14,4,14,4,10,"roboczy"
2017-05-10 23:00:00,2017-05-10,23,3,2,1,5,0,5,5,3,8,6,3,3,6,3,3,1,19,12,7,7,1,6,3,3,"roboczy"
2017-05-11 00:00:00,2017-05-11,0,5,1,4,0,1,0,3,4,2,2,1,1,2,1,1,0,8,6,2,4,1,9,4,5,"roboczy"
2017-05-11 01:00:00,2017-05-11,1,1,1,0,4,0,0,0,0,1,1,1,0,0,0,0,0,1,0,1,0,0,2,1,1,"roboczy"
2017-05-11 02:00:00,2017-05-11,2,0,0,0,2,0,0,0,0,0,0,0,0,0,0,0,0,6,3,3,1,0,0,0,0,"roboczy"
2017-05-11 03:00:00,2017-05-11,3,0,0,0,1,0,0,1,1,0,0,0,0,0,0,0,0,2,0,2,2,0,0,0,0,"roboczy"
2017-05-11 04:00:00,2017-05-11,4,1,1,0,1,0,0,1,4,2,1,0,1,0,0,0,0,2,2,0,4,4,0,0,0,"roboczy"
2017-05-11 05:00:00,2017-05-11,5,6,4,2,12,1,0,5,3,6,5,3,2,4,1,3,0,9,3,6,10,2,6,0,6,"roboczy"
2017-05-11 06:00:00,2017-05-11,6,12,10,2,55,2,8,26,16,14,25,11,14,33,6,27,2,41,25,16,32,8,30,8,22,"roboczy"
2017-05-11 07:00:00,2017-05-11,7,42,29,13,160,12,50,71,53,35,72,27,45,48,12,36,0,175,108,67,82,21,133,35,98,"roboczy"
2017-05-11 08:00:00,2017-05-11,8,36,25,11,226,7,73,57,43,57,57,24,33,54,9,45,0,239,111,128,78,10,123,24,99,"roboczy"
2017-05-11 09:00:00,2017-05-11,9,13,8,5,96,4,27,21,19,24,34,12,22,28,7,21,1,104,57,47,34,9,56,16,40,"roboczy"
2017-05-11 10:00:00,2017-05-11,10,5,1,4,65,1,8,15,16,23,21,15,6,12,4,8,0,72,36,36,19,2,31,10,21,"roboczy"
2017-05-11 11:00:00,2017-05-11,11,10,7,3,49,2,10,14,12,19,33,22,11,13,4,9,1,70,27,43,19,7,19,8,11,"roboczy"
2017-05-11 12:00:00,2017-05-11,12,8,4,4,47,1,14,25,28,15,23,16,7,15,6,9,0,58,29,29,20,4,33,8,25,"roboczy"
2017-05-11 13:00:00,2017-05-11,13,11,6,5,55,3,10,15,14,25,20,14,6,12,4,8,4,65,38,27,21,12,39,16,23,"roboczy"
2017-05-11 14:00:00,2017-05-11,14,13,8,5,62,5,14,26,22,21,35,24,11,18,8,10,0,103,55,48,40,9,47,13,34,"roboczy"
2017-05-11 15:00:00,2017-05-11,15,32,14,18,144,9,44,46,42,54,77,25,52,59,9,50,2,172,91,81,86,23,86,30,56,"roboczy"
2017-05-11 16:00:00,2017-05-11,16,56,35,21,261,6,107,81,88,97,134,66,68,93,16,77,11,294,160,134,99,26,163,23,140,"roboczy"
2017-05-11 17:00:00,2017-05-11,17,77,52,25,257,11,114,69,65,69,124,40,84,98,7,91,26,285,148,137,119,41,163,32,131,"roboczy"
2017-05-11 18:00:00,2017-05-11,18,80,58,22,146,14,90,66,40,73,113,19,94,81,6,75,30,260,142,118,104,38,121,22,99,"roboczy"
2017-05-11 19:00:00,2017-05-11,19,57,37,20,165,9,67,48,40,46,106,9,97,73,3,70,32,179,100,79,102,32,145,24,121,"roboczy"
2017-05-11 20:00:00,2017-05-11,20,47,30,17,106,10,60,50,28,68,76,8,68,58,7,51,30,170,103,67,77,29,74,15,59,"roboczy"
2017-05-11 21:00:00,2017-05-11,21,21,12,9,53,3,40,30,22,19,43,4,39,26,2,24,4,95,63,32,48,10,50,14,36,"roboczy"
2017-05-11 22:00:00,2017-05-11,22,15,6,9,48,6,12,12,20,21,13,3,10,19,0,19,2,73,42,31,35,6,28,10,18,"roboczy"
2017-05-11 23:00:00,2017-05-11,23,5,3,2,25,0,11,7,10,12,5,4,1,2,0,2,2,35,26,9,16,1,9,0,9,"roboczy"
2017-05-12 00:00:00,2017-05-12,0,2,2,0,8,0,5,4,5,7,1,0,1,2,0,2,0,24,17,7,5,1,7,3,4,"roboczy"
2017-05-12 01:00:00,2017-05-12,1,3,0,3,0,1,2,4,2,1,1,1,0,0,0,0,0,16,10,6,1,1,1,0,1,"roboczy"
2017-05-12 02:00:00,2017-05-12,2,1,1,0,3,0,2,1,2,3,1,1,0,0,0,0,0,15,12,3,0,0,2,1,1,"roboczy"
2017-05-12 03:00:00,2017-05-12,3,1,1,0,1,1,0,0,0,1,1,0,1,0,0,0,1,3,3,0,2,1,1,1,0,"roboczy"
2017-05-12 04:00:00,2017-05-12,4,3,2,1,3,0,1,1,3,2,2,0,2,2,0,2,0,4,3,1,6,2,1,0,1,"roboczy"
2017-05-12 05:00:00,2017-05-12,5,6,4,2,11,2,3,15,8,7,15,4,11,9,0,9,0,13,6,7,16,4,11,2,9,"roboczy"
2017-05-12 06:00:00,2017-05-12,6,27,23,4,75,8,23,46,26,19,36,9,27,44,4,40,3,76,45,31,65,26,53,14,39,"roboczy"
2017-05-12 07:00:00,2017-05-12,7,59,40,19,226,17,57,84,69,52,88,22,66,76,10,66,1,216,119,97,135,27,146,32,114,"roboczy"
2017-05-12 08:00:00,2017-05-12,8,59,33,26,319,13,107,99,64,88,79,18,61,89,12,77,14,372,177,195,130,26,222,49,173,"roboczy"
2017-05-12 09:00:00,2017-05-12,9,35,23,12,212,7,86,56,51,63,54,16,38,56,9,47,11,250,132,118,69,16,131,25,106,"roboczy"
2017-05-12 10:00:00,2017-05-12,10,44,29,15,144,5,36,48,24,46,66,25,41,38,5,33,7,184,87,97,47,13,96,32,64,"roboczy"
2017-05-12 11:00:00,2017-05-12,11,46,24,22,127,9,36,52,51,45,55,17,38,40,8,32,13,186,87,99,58,27,78,32,46,"roboczy"
2017-05-12 12:00:00,2017-05-12,12,59,27,32,142,15,63,37,43,66,81,32,49,68,12,56,25,207,86,121,93,37,91,27,64,"roboczy"
2017-05-12 13:00:00,2017-05-12,13,55,38,17,125,7,62,58,72,70,128,51,77,78,12,66,20,212,123,89,86,35,99,30,69,"roboczy"
2017-05-12 14:00:00,2017-05-12,14,68,39,29,160,9,74,70,60,104,159,65,94,99,14,85,36,259,128,131,110,44,120,30,90,"roboczy"
2017-05-12 15:00:00,2017-05-12,15,83,49,34,266,15,116,85,101,116,192,71,121,117,13,104,39,334,189,145,162,43,165,39,126,"roboczy"
2017-05-12 16:00:00,2017-05-12,16,109,79,30,370,14,192,143,142,141,290,143,147,147,16,131,32,496,248,248,215,71,241,38,203,"roboczy"
2017-05-12 17:00:00,2017-05-12,17,182,117,65,336,23,180,143,117,100,300,95,205,183,8,175,65,535,285,250,220,65,263,51,212,"roboczy"
2017-05-12 18:00:00,2017-05-12,18,168,123,45,280,26,153,104,100,86,281,68,213,188,4,184,112,406,211,195,185,74,221,51,170,"roboczy"
2017-05-12 19:00:00,2017-05-12,19,141,94,47,206,18,102,128,90,83,239,34,205,168,2,166,76,334,202,132,179,74,197,31,166,"roboczy"
2017-05-12 20:00:00,2017-05-12,20,99,73,26,161,16,90,85,77,78,157,8,149,173,4,169,39,231,118,113,144,54,124,22,102,"roboczy"
2017-05-12 21:00:00,2017-05-12,21,58,36,22,77,7,57,40,50,60,100,8,92,89,2,87,4,198,136,62,94,25,70,16,54,"roboczy"
2017-05-12 22:00:00,2017-05-12,22,28,20,8,63,6,52,26,21,49,41,3,38,75,1,74,4,156,106,50,57,15,42,10,32,"roboczy"
2017-05-12 23:00:00,2017-05-12,23,29,22,7,23,0,22,21,26,33,22,1,21,26,0,26,0,91,67,24,37,7,27,7,20,"roboczy"
2017-05-13 00:00:00,2017-05-13,0,12,8,4,20,1,12,8,21,19,11,0,11,32,0,32,1,65,44,21,17,1,16,8,8,"weekend"
2017-05-13 01:00:00,2017-05-13,1,7,6,1,25,1,7,14,6,10,12,0,12,26,0,26,0,49,46,3,8,2,14,6,8,"weekend"
2017-05-13 02:00:00,2017-05-13,2,3,3,0,10,0,11,2,3,8,3,0,3,9,0,9,3,29,20,9,3,0,2,0,2,"weekend"
2017-05-13 03:00:00,2017-05-13,3,7,3,4,10,0,4,4,3,14,2,0,2,1,0,1,0,12,7,5,3,0,4,3,1,"weekend"
2017-05-13 04:00:00,2017-05-13,4,3,2,1,2,0,2,2,3,2,1,0,1,5,0,5,1,4,4,0,4,3,0,0,0,"weekend"
2017-05-13 05:00:00,2017-05-13,5,2,2,0,9,0,1,8,8,4,8,4,4,6,1,5,0,13,4,9,11,5,4,0,4,"weekend"
2017-05-13 06:00:00,2017-05-13,6,13,10,3,14,2,14,19,16,3,14,2,12,21,2,19,2,27,15,12,31,9,15,8,7,"weekend"
2017-05-13 07:00:00,2017-05-13,7,8,8,0,55,4,20,24,22,19,34,8,26,24,3,21,5,57,37,20,35,8,42,14,28,"weekend"
2017-05-13 08:00:00,2017-05-13,8,18,13,5,82,6,23,30,24,21,68,10,58,41,5,36,6,96,52,44,40,22,56,17,39,"weekend"
2017-05-13 09:00:00,2017-05-13,9,43,19,24,99,8,35,51,44,35,83,15,68,58,13,45,21,136,58,78,88,33,65,12,53,"weekend"
2017-05-13 10:00:00,2017-05-13,10,69,51,18,138,31,81,50,58,41,128,27,101,89,11,78,29,200,91,109,141,40,94,17,77,"weekend"
2017-05-13 11:00:00,2017-05-13,11,107,73,34,187,20,144,80,98,71,196,31,165,109,15,94,105,239,124,115,183,61,134,20,114,"weekend"
2017-05-13 12:00:00,2017-05-13,12,155,102,53,227,31,149,140,134,91,271,51,220,194,23,171,136,375,203,172,272,108,203,43,160,"weekend"
2017-05-13 13:00:00,2017-05-13,13,141,89,52,335,39,207,158,131,135,425,117,308,260,30,230,145,412,222,190,305,88,188,30,158,"weekend"
2017-05-13 14:00:00,2017-05-13,14,161,111,50,344,28,170,148,122,131,590,224,366,304,40,264,166,464,224,240,312,77,200,25,175,"weekend"
2017-05-13 15:00:00,2017-05-13,15,171,107,64,355,25,177,163,146,107,607,248,359,377,62,315,218,482,264,218,355,97,227,53,174,"weekend"
2017-05-13 16:00:00,2017-05-13,16,166,117,49,372,24,203,139,129,134,577,198,379,409,29,380,163,469,287,182,303,97,243,44,199,"weekend"
2017-05-13 17:00:00,2017-05-13,17,186,115,71,289,24,196,182,148,121,428,26,402,365,16,349,191,433,254,179,384,130,256,46,210,"weekend"
2017-05-13 18:00:00,2017-05-13,18,170,92,78,262,35,157,145,136,115,358,11,347,329,6,323,170,486,288,198,322,156,252,37,215,"weekend"
2017-05-13 19:00:00,2017-05-13,19,161,105,56,246,32,106,134,113,103,303,5,298,282,4,278,103,400,240,160,272,103,190,41,149,"weekend"
2017-05-13 20:00:00,2017-05-13,20,110,65,45,185,11,106,92,92,71,174,3,171,210,3,207,53,279,182,97,207,54,132,29,103,"weekend"
2017-05-13 21:00:00,2017-05-13,21,76,54,22,108,10,69,67,61,66,142,4,138,148,3,145,24,203,115,88,161,31,52,8,44,"weekend"
2017-05-13 22:00:00,2017-05-13,22,45,33,12,58,8,53,52,41,55,47,3,44,97,1,96,6,183,107,76,47,25,43,8,35,"weekend"
2017-05-13 23:00:00,2017-05-13,23,23,20,3,44,0,39,19,17,23,36,2,34,47,0,47,2,100,68,32,34,7,29,8,21,"weekend"
2017-05-14 00:00:00,2017-05-14,0,13,8,5,11,0,10,12,13,13,21,0,21,38,1,37,5,56,40,16,14,4,19,6,13,"weekend"
2017-05-14 01:00:00,2017-05-14,1,12,12,0,13,3,13,10,9,16,7,0,7,17,0,17,0,66,41,25,5,3,20,6,14,"weekend"
2017-05-14 02:00:00,2017-05-14,2,10,4,6,9,2,10,7,3,6,3,0,3,10,0,10,2,37,28,9,3,2,6,3,3,"weekend"
2017-05-14 03:00:00,2017-05-14,3,3,2,1,2,0,4,3,4,9,1,0,1,7,0,7,0,26,19,7,1,0,9,0,9,"weekend"
2017-05-14 04:00:00,2017-05-14,4,1,1,0,2,0,0,3,4,12,0,0,0,2,0,2,4,16,12,4,4,1,1,1,0,"weekend"
2017-05-14 05:00:00,2017-05-14,5,3,2,1,5,1,4,2,7,1,7,2,5,3,0,3,2,14,5,9,9,5,5,1,4,"weekend"
2017-05-14 06:00:00,2017-05-14,6,5,4,1,15,1,3,9,11,7,12,2,10,9,1,8,6,21,12,9,16,3,16,4,12,"weekend"
2017-05-14 07:00:00,2017-05-14,7,9,4,5,29,2,9,13,11,12,18,4,14,10,5,5,4,31,18,13,23,7,20,6,14,"weekend"
2017-05-14 08:00:00,2017-05-14,8,28,18,10,51,5,30,20,23,14,37,4,33,40,4,36,15,57,25,32,40,21,36,7,29,"weekend"
2017-05-14 09:00:00,2017-05-14,9,31,10,21,77,18,32,40,47,29,109,15,94,67,8,59,24,90,49,41,105,37,63,11,52,"weekend"
2017-05-14 10:00:00,2017-05-14,10,91,59,32,174,14,87,60,57,33,164,30,134,109,18,91,72,194,76,118,158,75,125,22,103,"weekend"
2017-05-14 11:00:00,2017-05-14,11,142,102,40,271,24,168,119,78,72,328,49,279,199,28,171,142,312,151,161,274,97,207,26,181,"weekend"
2017-05-14 12:00:00,2017-05-14,12,177,109,68,306,36,234,161,109,79,533,110,423,357,37,320,229,400,145,255,334,131,212,33,179,"weekend"
2017-05-14 13:00:00,2017-05-14,13,213,155,58,333,55,239,204,146,96,879,322,557,495,60,435,264,472,251,221,476,147,322,50,272,"weekend"
2017-05-14 14:00:00,2017-05-14,14,223,159,64,410,37,231,164,160,136,867,293,574,477,53,424,279,529,289,240,445,158,289,56,233,"weekend"
2017-05-14 15:00:00,2017-05-14,15,204,141,63,374,57,224,152,129,161,711,227,484,468,47,421,235,447,254,193,400,141,251,44,207,"weekend"
2017-05-14 16:00:00,2017-05-14,16,276,187,89,382,46,237,202,171,137,582,76,506,460,31,429,267,498,283,215,412,116,298,36,262,"weekend"
2017-05-14 17:00:00,2017-05-14,17,260,184,76,362,42,236,187,145,151,545,29,516,500,19,481,223,545,315,230,427,152,297,41,256,"weekend"
2017-05-14 18:00:00,2017-05-14,18,219,134,85,334,44,209,184,146,140,430,18,412,440,14,426,166,487,323,164,376,115,268,39,229,"weekend"
2017-05-14 19:00:00,2017-05-14,19,172,123,49,250,19,170,178,110,105,284,9,275,328,10,318,111,404,230,174,275,110,202,35,167,"weekend"
2017-05-14 20:00:00,2017-05-14,20,139,90,49,225,12,103,128,112,110,166,4,162,255,6,249,71,330,200,130,192,96,168,27,141,"weekend"
2017-05-14 21:00:00,2017-05-14,21,71,49,22,106,6,42,65,59,45,92,5,87,101,2,99,9,201,132,69,101,29,102,26,76,"weekend"
2017-05-14 22:00:00,2017-05-14,22,25,19,6,42,5,22,22,32,38,34,3,31,60,2,58,4,162,100,62,61,19,40,9,31,"weekend"
2017-05-14 23:00:00,2017-05-14,23,5,4,1,26,0,17,13,15,3,8,2,6,17,2,15,2,53,29,24,14,0,18,4,14,"weekend"
2017-05-15 00:00:00,2017-05-15,0,7,6,1,15,1,4,8,5,16,11,0,11,5,0,5,0,29,21,8,4,0,14,2,12,"roboczy"
2017-05-15 01:00:00,2017-05-15,1,1,1,0,5,0,6,2,3,8,1,0,1,3,0,3,0,21,16,5,5,0,2,0,2,"roboczy"
2017-05-15 02:00:00,2017-05-15,2,1,1,0,0,0,1,1,0,1,2,0,2,3,0,3,0,7,5,2,2,0,3,1,2,"roboczy"
2017-05-15 03:00:00,2017-05-15,3,1,0,1,2,0,0,1,2,2,1,0,1,3,0,3,2,3,2,1,1,0,0,0,0,"roboczy"
2017-05-15 04:00:00,2017-05-15,4,2,2,0,4,1,1,5,6,3,2,0,2,2,0,2,0,2,2,0,4,3,2,2,0,"roboczy"
2017-05-15 05:00:00,2017-05-15,5,7,5,2,13,5,12,25,12,9,14,1,13,15,0,15,0,23,10,13,27,8,13,1,12,"roboczy"
2017-05-15 06:00:00,2017-05-15,6,37,27,10,117,12,23,67,40,26,43,6,37,45,1,44,1,99,56,43,91,30,74,16,58,"roboczy"
2017-05-15 07:00:00,2017-05-15,7,89,52,37,318,19,88,137,81,78,103,17,86,116,10,106,5,345,161,184,173,42,229,45,184,"roboczy"
2017-05-15 08:00:00,2017-05-15,8,77,48,29,411,13,149,135,76,109,100,14,86,101,6,95,9,502,254,248,184,29,312,66,246,"roboczy"
2017-05-15 09:00:00,2017-05-15,9,46,34,12,207,3,78,48,49,76,59,9,50,56,5,51,11,257,123,134,74,17,135,25,110,"roboczy"
2017-05-15 10:00:00,2017-05-15,10,30,18,12,105,6,37,30,34,45,22,4,18,25,2,23,5,145,71,74,53,17,87,33,54,"roboczy"
2017-05-15 11:00:00,2017-05-15,11,35,20,15,106,5,27,39,20,53,28,8,20,34,5,29,9,164,93,71,43,23,62,20,42,"roboczy"
2017-05-15 12:00:00,2017-05-15,12,48,31,17,104,8,41,29,42,60,39,11,28,26,4,22,17,162,93,69,57,18,54,23,31,"roboczy"
2017-05-15 13:00:00,2017-05-15,13,41,28,13,122,6,48,45,48,64,51,11,40,39,5,34,16,186,108,78,56,28,65,24,41,"roboczy"
2017-05-15 14:00:00,2017-05-15,14,44,29,15,140,15,71,64,72,65,38,13,25,52,7,45,14,232,137,95,79,29,113,37,76,"roboczy"
2017-05-15 15:00:00,2017-05-15,15,86,55,31,211,30,89,92,94,97,105,26,79,108,11,97,24,336,180,156,137,73,179,47,132,"roboczy"
2017-05-15 16:00:00,2017-05-15,16,117,79,38,358,23,195,138,111,165,233,85,148,159,17,142,35,491,269,222,231,63,282,49,233,"roboczy"
2017-05-15 17:00:00,2017-05-15,17,129,81,48,392,15,217,162,119,124,234,98,136,171,15,156,38,542,278,264,193,65,319,67,252,"roboczy"
2017-05-15 18:00:00,2017-05-15,18,194,117,77,308,20,172,125,100,92,203,43,160,186,7,179,76,432,224,208,219,70,234,45,189,"roboczy"
2017-05-15 19:00:00,2017-05-15,19,156,100,56,232,26,130,127,126,104,208,18,190,189,7,182,81,353,206,147,202,94,227,39,188,"roboczy"
2017-05-15 20:00:00,2017-05-15,20,151,105,46,221,24,110,104,101,81,123,6,117,149,3,146,67,305,182,123,161,70,207,48,159,"roboczy"
2017-05-15 21:00:00,2017-05-15,21,67,41,26,110,12,64,67,53,53,90,5,85,104,2,102,10,207,141,66,78,29,113,27,86,"roboczy"
2017-05-15 22:00:00,2017-05-15,22,29,25,4,47,8,35,41,24,48,32,2,30,48,1,47,3,138,85,53,56,12,56,11,45,"roboczy"
2017-05-15 23:00:00,2017-05-15,23,17,14,3,19,1,27,17,22,21,11,1,10,30,2,28,0,84,56,28,22,1,18,9,9,"roboczy"
2017-05-16 00:00:00,2017-05-16,0,13,8,5,11,1,4,4,9,10,4,1,3,7,0,7,3,41,25,16,6,0,14,4,10,"roboczy"
2017-05-16 01:00:00,2017-05-16,1,0,0,0,9,0,8,2,5,9,2,1,1,5,0,5,0,23,14,9,9,1,3,3,0,"roboczy"
2017-05-16 02:00:00,2017-05-16,2,2,1,1,3,0,2,1,3,3,3,0,3,0,0,0,0,19,13,6,3,0,3,1,2,"roboczy"
2017-05-16 03:00:00,2017-05-16,3,2,1,1,3,1,0,3,1,1,1,0,1,3,0,3,0,8,5,3,2,2,1,1,0,"roboczy"
2017-05-16 04:00:00,2017-05-16,4,2,0,2,6,2,0,3,3,0,2,0,2,5,0,5,0,4,3,1,5,6,1,0,1,"roboczy"
2017-05-16 05:00:00,2017-05-16,5,8,5,3,22,6,6,18,10,5,15,2,13,18,0,18,0,28,10,18,30,16,15,2,13,"roboczy"
2017-05-16 06:00:00,2017-05-16,6,44,34,10,122,13,25,85,28,32,54,11,43,56,5,51,2,128,66,62,99,36,80,19,61,"roboczy"
2017-05-16 07:00:00,2017-05-16,7,111,68,43,388,24,86,152,98,95,124,23,101,126,12,114,7,411,211,200,207,52,276,63,213,"roboczy"
2017-05-16 08:00:00,2017-05-16,8,105,61,44,538,21,185,155,108,137,107,21,86,116,11,105,10,568,272,296,203,38,347,87,260,"roboczy"
2017-05-16 09:00:00,2017-05-16,9,50,30,20,279,4,102,67,60,100,77,14,63,82,9,73,13,375,188,187,128,19,176,38,138,"roboczy"
2017-05-16 10:00:00,2017-05-16,10,44,25,19,182,4,51,56,51,64,51,17,34,58,5,53,16,245,125,120,67,16,124,34,90,"roboczy"
2017-05-16 11:00:00,2017-05-16,11,48,28,20,147,12,42,65,57,43,101,22,79,50,7,43,21,218,121,97,70,31,117,37,80,"roboczy"
2017-05-16 12:00:00,2017-05-16,12,59,42,17,184,17,57,60,64,76,81,17,64,66,13,53,22,244,131,113,92,27,106,34,72,"roboczy"
2017-05-16 13:00:00,2017-05-16,13,73,46,27,159,9,65,67,79,100,112,23,89,81,13,68,38,257,135,122,119,33,130,42,88,"roboczy"
2017-05-16 14:00:00,2017-05-16,14,78,46,32,168,11,71,75,70,107,117,33,84,102,11,91,31,311,171,140,133,53,152,42,110,"roboczy"
2017-05-16 15:00:00,2017-05-16,15,114,66,48,286,22,129,154,116,107,191,57,134,164,15,149,56,371,205,166,199,56,227,43,184,"roboczy"
2017-05-16 16:00:00,2017-05-16,16,132,88,44,548,31,261,190,180,170,350,163,187,208,28,180,57,672,378,294,311,98,399,73,326,"roboczy"
2017-05-16 17:00:00,2017-05-16,17,212,143,69,559,32,283,195,143,159,397,157,240,310,23,287,88,765,382,383,334,123,433,77,356,"roboczy"
2017-05-16 18:00:00,2017-05-16,18,238,150,88,428,29,225,174,153,132,315,45,270,282,9,273,141,606,310,296,289,115,341,55,286,"roboczy"
2017-05-16 19:00:00,2017-05-16,19,199,128,71,317,33,155,192,158,115,289,16,273,280,6,274,106,521,313,208,276,125,290,50,240,"roboczy"
2017-05-16 20:00:00,2017-05-16,20,146,90,56,243,26,142,135,155,73,185,13,172,243,9,234,78,411,263,148,216,77,226,40,186,"roboczy"
2017-05-16 21:00:00,2017-05-16,21,82,56,26,152,16,84,70,81,71,109,9,100,109,6,103,27,288,186,102,139,32,143,43,100,"roboczy"
2017-05-16 22:00:00,2017-05-16,22,50,37,13,81,4,30,45,37,39,57,3,54,70,1,69,10,218,130,88,82,24,54,11,43,"roboczy"
2017-05-16 23:00:00,2017-05-16,23,25,15,10,37,4,23,19,21,27,13,1,12,23,0,23,3,66,47,19,25,6,36,11,25,"roboczy"
2017-05-17 00:00:00,2017-05-17,0,7,5,2,10,1,18,11,4,7,4,0,4,12,0,12,0,46,30,16,5,4,6,1,5,"roboczy"
2017-05-17 01:00:00,2017-05-17,1,3,1,2,1,0,0,4,4,7,2,1,1,4,0,4,0,19,14,5,7,1,5,1,4,"roboczy"
2017-05-17 02:00:00,2017-05-17,2,0,0,0,3,0,1,0,5,3,1,1,0,0,0,0,0,18,8,10,0,1,2,1,1,"roboczy"
2017-05-17 03:00:00,2017-05-17,3,1,0,1,2,0,0,3,3,1,2,0,2,2,0,2,1,8,4,4,4,1,3,1,2,"roboczy"
2017-05-17 04:00:00,2017-05-17,4,3,3,0,4,3,2,6,4,0,2,0,2,6,0,6,1,6,3,3,6,3,4,2,2,"roboczy"
2017-05-17 05:00:00,2017-05-17,5,8,6,2,29,7,13,30,13,9,18,3,15,21,2,19,0,28,10,18,38,14,18,3,15,"roboczy"
2017-05-17 06:00:00,2017-05-17,6,46,31,15,138,15,33,86,34,42,59,9,50,73,4,69,2,148,77,71,120,36,90,20,70,"roboczy"
2017-05-17 07:00:00,2017-05-17,7,104,76,28,406,27,121,175,110,101,133,17,116,129,6,123,7,430,234,196,217,46,276,73,203,"roboczy"
2017-05-17 08:00:00,2017-05-17,8,104,77,27,565,16,178,162,126,138,102,12,90,138,10,128,14,627,319,308,236,47,390,79,311,"roboczy"
2017-05-17 09:00:00,2017-05-17,9,73,43,30,285,10,106,97,69,92,64,8,56,95,6,89,26,419,202,217,126,37,198,48,150,"roboczy"
2017-05-17 10:00:00,2017-05-17,10,40,26,14,202,8,63,65,57,62,78,10,68,68,6,62,14,244,128,116,90,25,114,28,86,"roboczy"
2017-05-17 11:00:00,2017-05-17,11,61,38,23,158,13,57,60,52,70,81,11,70,56,7,49,28,266,147,119,117,39,115,34,81,"roboczy"
2017-05-17 12:00:00,2017-05-17,12,71,39,32,157,10,56,57,56,66,88,12,76,65,9,56,42,260,151,109,105,31,129,36,93,"roboczy"
2017-05-17 13:00:00,2017-05-17,13,66,40,26,176,9,69,76,64,86,112,13,99,71,9,62,45,263,162,101,129,43,130,42,88,"roboczy"
2017-05-17 14:00:00,2017-05-17,14,86,56,30,192,8,83,91,105,106,115,21,94,110,10,100,36,308,167,141,135,58,156,35,121,"roboczy"
2017-05-17 15:00:00,2017-05-17,15,112,71,41,311,20,127,137,112,142,155,36,119,119,12,107,50,475,271,204,222,64,217,46,171,"roboczy"
2017-05-17 16:00:00,2017-05-17,16,139,95,44,566,20,254,201,162,194,269,76,193,239,19,220,63,687,374,313,322,84,365,72,293,"roboczy"
2017-05-17 17:00:00,2017-05-17,17,209,129,80,561,28,307,208,158,165,360,132,228,282,15,267,78,765,413,352,341,112,444,72,372,"roboczy"
2017-05-17 18:00:00,2017-05-17,18,252,174,78,415,30,216,173,158,142,292,57,235,301,13,288,136,572,291,281,285,101,328,48,280,"roboczy"
2017-05-17 19:00:00,2017-05-17,19,234,157,77,366,37,208,165,149,115,294,20,274,319,4,315,122,558,303,255,322,115,286,50,236,"roboczy"
2017-05-17 20:00:00,2017-05-17,20,164,115,49,267,26,172,129,127,76,234,10,224,261,8,253,108,425,255,170,268,86,216,36,180,"roboczy"
2017-05-17 21:00:00,2017-05-17,21,97,63,34,171,15,106,84,73,98,110,3,107,161,2,159,19,308,203,105,141,58,148,33,115,"roboczy"
2017-05-17 22:00:00,2017-05-17,22,47,37,10,86,6,54,57,51,39,75,5,70,123,1,122,3,210,148,62,105,19,60,16,44,"roboczy"
2017-05-17 23:00:00,2017-05-17,23,18,13,5,41,0,27,35,25,21,25,3,22,35,3,32,2,99,71,28,47,7,24,3,21,"roboczy"
2017-05-18 00:00:00,2017-05-18,0,17,9,8,21,1,9,9,11,9,14,1,13,22,1,21,0,51,37,14,18,3,15,2,13,"roboczy"
2017-05-18 01:00:00,2017-05-18,1,7,6,1,5,0,5,9,3,4,7,1,6,7,0,7,0,17,8,9,7,0,19,11,8,"roboczy"
2017-05-18 02:00:00,2017-05-18,2,0,0,0,6,0,1,0,5,5,0,0,0,1,0,1,0,18,10,8,2,0,2,0,2,"roboczy"
2017-05-18 03:00:00,2017-05-18,3,1,1,0,4,0,1,2,2,0,0,0,0,0,0,0,2,5,1,4,2,7,2,1,1,"roboczy"
2017-05-18 04:00:00,2017-05-18,4,2,2,0,3,2,2,14,4,4,4,0,4,2,0,2,0,5,3,2,5,4,3,1,2,"roboczy"
2017-05-18 05:00:00,2017-05-18,5,12,9,3,27,5,10,27,17,5,22,3,19,22,1,21,2,28,11,17,49,16,18,3,15,"roboczy"
2017-05-18 06:00:00,2017-05-18,6,43,33,10,150,15,44,90,38,33,53,11,42,57,6,51,2,145,69,76,128,44,104,18,86,"roboczy"
2017-05-18 07:00:00,2017-05-18,7,100,65,35,421,22,128,181,109,98,136,41,95,140,12,128,9,427,216,211,216,53,289,71,218,"roboczy"
2017-05-18 08:00:00,2017-05-18,8,106,79,27,562,18,196,191,131,148,146,32,114,145,9,136,20,658,328,330,235,36,374,69,305,"roboczy"
2017-05-18 09:00:00,2017-05-18,9,91,60,31,320,13,133,101,78,96,90,12,78,86,7,79,19,438,222,216,138,29,193,36,157,"roboczy"
2017-05-18 10:00:00,2017-05-18,10,48,37,11,192,8,87,56,70,70,72,15,57,59,4,55,15,226,122,104,89,26,94,24,70,"roboczy"
2017-05-18 11:00:00,2017-05-18,11,55,39,16,167,19,64,68,55,64,96,23,73,59,4,55,22,234,124,110,112,45,119,40,79,"roboczy"
2017-05-18 12:00:00,2017-05-18,12,52,35,17,172,16,80,63,67,64,59,16,43,64,6,58,41,237,126,111,113,43,152,38,114,"roboczy"
2017-05-18 13:00:00,2017-05-18,13,79,45,34,183,12,81,68,55,70,105,14,91,68,4,64,32,333,184,149,109,38,167,44,123,"roboczy"
2017-05-18 14:00:00,2017-05-18,14,85,51,34,200,14,94,99,97,92,115,36,79,104,8,96,42,328,190,138,157,66,147,38,109,"roboczy"
2017-05-18 15:00:00,2017-05-18,15,131,69,62,308,19,134,147,122,117,198,41,157,144,9,135,68,496,268,228,250,71,246,49,197,"roboczy"
2017-05-18 16:00:00,2017-05-18,16,173,120,53,520,20,270,225,166,179,291,69,222,242,16,226,47,753,398,355,389,94,365,55,310,"roboczy"
2017-05-18 17:00:00,2017-05-18,17,191,134,57,639,26,323,216,165,155,315,47,268,300,7,293,108,755,390,365,336,102,456,65,391,"roboczy"
2017-05-18 18:00:00,2017-05-18,18,245,168,77,443,48,220,220,153,126,318,20,298,302,6,296,139,610,310,300,328,117,383,51,332,"roboczy"
2017-05-18 19:00:00,2017-05-18,19,269,181,88,327,33,178,193,135,104,289,9,280,353,3,350,121,518,291,227,272,137,324,61,263,"roboczy"
2017-05-18 20:00:00,2017-05-18,20,223,147,76,272,19,131,143,115,108,261,8,253,286,7,279,94,434,266,168,217,105,227,40,187,"roboczy"
2017-05-18 21:00:00,2017-05-18,21,119,72,47,154,18,87,93,60,76,125,4,121,213,2,211,30,353,237,116,133,50,121,26,95,"roboczy"
2017-05-18 22:00:00,2017-05-18,22,64,44,20,86,5,57,52,60,52,74,3,71,84,0,84,3,212,148,64,92,22,66,16,50,"roboczy"
2017-05-18 23:00:00,2017-05-18,23,38,34,4,53,1,21,32,25,39,40,4,36,61,0,61,4,147,107,40,26,7,43,11,32,"roboczy"
2017-05-19 00:00:00,2017-05-19,0,23,13,10,21,3,16,10,10,24,8,0,8,29,0,29,0,70,55,15,27,5,26,6,20,"roboczy"
2017-05-19 01:00:00,2017-05-19,1,5,3,2,7,1,10,3,7,8,2,1,1,8,0,8,0,31,24,7,3,3,7,1,6,"roboczy"
2017-05-19 02:00:00,2017-05-19,2,1,1,0,3,0,3,0,3,3,1,1,0,3,0,3,1,18,14,4,8,0,5,4,1,"roboczy"
2017-05-19 03:00:00,2017-05-19,3,1,0,1,2,1,0,4,5,5,2,0,2,1,0,1,2,8,5,3,2,4,3,1,2,"roboczy"
2017-05-19 04:00:00,2017-05-19,4,5,3,2,3,2,1,8,3,1,2,0,2,2,0,2,0,8,6,2,4,5,2,1,1,"roboczy"
2017-05-19 05:00:00,2017-05-19,5,4,4,0,21,8,6,31,18,3,19,4,15,22,0,22,3,28,16,12,34,14,19,4,15,"roboczy"
2017-05-19 06:00:00,2017-05-19,6,41,34,7,133,15,37,101,49,31,51,9,42,74,4,70,8,130,65,65,123,41,101,30,71,"roboczy"
2017-05-19 07:00:00,2017-05-19,7,96,60,36,437,23,119,186,121,106,119,22,97,109,10,99,14,440,230,210,237,55,288,64,224,"roboczy"
2017-05-19 08:00:00,2017-05-19,8,107,77,30,570,13,175,146,118,127,116,18,98,138,12,126,20,600,313,287,210,34,364,81,283,"roboczy"
2017-05-19 09:00:00,2017-05-19,9,71,49,22,279,11,99,82,49,117,67,16,51,85,9,76,17,441,222,219,130,32,185,51,134,"roboczy"
2017-05-19 10:00:00,2017-05-19,10,65,39,26,194,8,72,51,71,55,98,32,66,73,5,68,15,222,111,111,92,35,129,35,94,"roboczy"
2017-05-19 11:00:00,2017-05-19,11,61,32,29,167,13,73,64,52,71,89,22,67,58,8,50,35,240,119,121,107,41,108,27,81,"roboczy"
2017-05-19 12:00:00,2017-05-19,12,67,36,31,169,16,74,64,84,92,126,56,70,80,12,68,41,329,166,163,125,41,105,24,81,"roboczy"
2017-05-19 13:00:00,2017-05-19,13,83,52,31,181,15,78,71,77,105,187,79,108,83,12,71,52,306,182,124,151,41,153,41,112,"roboczy"
2017-05-19 14:00:00,2017-05-19,14,73,48,25,204,15,100,111,70,126,204,104,100,107,14,93,47,336,180,156,146,47,170,44,126,"roboczy"
2017-05-19 15:00:00,2017-05-19,15,129,91,38,283,24,168,164,151,143,260,108,152,188,14,174,60,510,290,220,265,64,235,42,193,"roboczy"
2017-05-19 16:00:00,2017-05-19,16,151,102,49,536,31,274,205,164,190,388,147,241,238,16,222,68,719,382,337,355,112,378,71,307,"roboczy"
2017-05-19 17:00:00,2017-05-19,17,197,129,68,556,27,279,191,167,164,351,92,259,297,8,289,116,701,373,328,358,83,404,64,340,"roboczy"
2017-05-19 18:00:00,2017-05-19,18,243,177,66,354,32,204,170,169,139,309,41,268,303,4,299,157,525,278,247,368,101,285,48,237,"roboczy"
2017-05-19 19:00:00,2017-05-19,19,241,152,89,325,41,173,180,173,117,265,22,243,339,2,337,147,477,267,210,293,109,296,46,250,"roboczy"
2017-05-19 20:00:00,2017-05-19,20,162,110,52,284,29,122,137,139,94,278,8,270,342,4,338,107,419,232,187,246,73,215,46,169,"roboczy"
2017-05-19 21:00:00,2017-05-19,21,107,72,35,174,18,86,114,110,75,181,8,173,212,2,210,50,314,197,117,158,52,130,25,105,"roboczy"
2017-05-19 22:00:00,2017-05-19,22,57,39,18,134,8,76,56,72,53,116,3,113,176,1,175,15,254,169,85,161,30,78,15,63,"roboczy"
2017-05-19 23:00:00,2017-05-19,23,49,34,15,92,3,30,35,41,55,66,1,65,106,0,106,13,171,116,55,52,15,55,9,46,"roboczy"
2017-05-20 00:00:00,2017-05-20,0,22,13,9,41,1,25,26,38,25,31,0,31,75,0,75,10,119,80,39,29,6,34,9,25,"weekend"
2017-05-20 01:00:00,2017-05-20,1,18,9,9,27,1,13,14,12,17,16,0,16,35,0,35,0,64,44,20,18,4,16,5,11,"weekend"
2017-05-20 02:00:00,2017-05-20,2,3,3,0,11,1,6,7,6,10,8,0,8,25,0,25,0,36,29,7,5,2,10,3,7,"weekend"
2017-05-20 03:00:00,2017-05-20,3,11,6,5,1,0,5,5,2,9,5,0,5,13,0,13,1,20,16,4,6,2,7,3,4,"weekend"
2017-05-20 04:00:00,2017-05-20,4,2,1,1,8,1,4,4,10,8,1,0,1,9,0,9,0,18,16,2,3,3,6,1,5,"weekend"
2017-05-20 05:00:00,2017-05-20,5,11,6,5,9,2,5,12,8,5,8,4,4,9,1,8,5,10,7,3,16,5,7,2,5,"weekend"
2017-05-20 06:00:00,2017-05-20,6,13,8,5,30,6,9,21,16,11,26,2,24,21,2,19,2,39,16,23,29,11,26,9,17,"weekend"
2017-05-20 07:00:00,2017-05-20,7,24,17,7,49,3,19,24,36,11,37,8,29,27,3,24,4,73,44,29,56,16,36,7,29,"weekend"
2017-05-20 08:00:00,2017-05-20,8,45,23,22,72,13,35,51,65,24,64,10,54,66,5,61,13,126,62,64,79,21,58,15,43,"weekend"
2017-05-20 09:00:00,2017-05-20,9,57,37,20,104,16,67,56,59,36,89,15,74,93,13,80,30,187,89,98,119,45,94,20,74,"weekend"
2017-05-20 10:00:00,2017-05-20,10,90,66,24,193,22,101,103,112,65,155,27,128,129,11,118,59,247,126,121,169,64,147,31,116,"weekend"
2017-05-20 11:00:00,2017-05-20,11,122,75,47,252,24,128,112,115,94,221,32,189,229,15,214,125,350,148,202,260,85,163,21,142,"weekend"
2017-05-20 12:00:00,2017-05-20,12,141,97,44,295,31,202,141,149,102,360,52,308,271,24,247,179,412,195,217,309,116,186,41,145,"weekend"
2017-05-20 13:00:00,2017-05-20,13,181,114,67,284,37,183,144,161,121,624,208,416,431,31,400,251,467,229,238,358,94,231,30,201,"weekend"
2017-05-20 14:00:00,2017-05-20,14,203,127,76,287,33,192,189,148,122,631,252,379,408,42,366,247,445,243,202,403,93,229,47,182,"weekend"
2017-05-20 15:00:00,2017-05-20,15,219,121,98,312,33,206,164,175,124,667,321,346,521,53,468,247,420,232,188,366,103,248,59,189,"weekend"
2017-05-20 16:00:00,2017-05-20,16,218,145,73,336,50,202,179,175,105,647,246,401,478,30,448,253,462,255,207,429,135,288,31,257,"weekend"
2017-05-20 17:00:00,2017-05-20,17,251,143,108,357,23,197,160,141,148,472,27,445,448,17,431,192,492,273,219,350,122,227,25,202,"weekend"
2017-05-20 18:00:00,2017-05-20,18,222,169,53,312,32,218,198,167,113,416,12,404,459,7,452,209,487,280,207,420,152,264,35,229,"weekend"
2017-05-20 19:00:00,2017-05-20,19,246,159,87,271,21,189,189,149,142,349,5,344,393,4,389,176,545,324,221,359,140,237,39,198,"weekend"
2017-05-20 20:00:00,2017-05-20,20,176,119,57,246,24,136,187,124,95,299,3,296,353,3,350,69,480,277,203,331,92,177,41,136,"weekend"
2017-05-20 21:00:00,2017-05-20,21,123,82,41,163,22,117,122,68,126,222,4,218,258,3,255,37,457,247,210,191,55,164,35,129,"weekend"
2017-05-20 22:00:00,2017-05-20,22,51,35,16,136,5,78,85,67,94,129,3,126,207,1,206,17,336,222,114,219,31,92,23,69,"weekend"
2017-05-20 23:00:00,2017-05-20,23,28,20,8,66,5,49,73,79,70,48,2,46,114,0,114,7,254,170,84,81,18,45,9,36,"weekend"
2017-05-21 00:00:00,2017-05-21,0,19,16,3,48,0,48,35,51,36,22,0,22,93,1,92,3,167,115,52,40,3,41,11,30,"weekend"
2017-05-21 01:00:00,2017-05-21,1,16,9,7,27,0,31,23,21,31,11,0,11,51,0,51,4,92,76,16,21,2,27,10,17,"weekend"
2017-05-21 02:00:00,2017-05-21,2,8,6,2,15,0,10,13,8,16,6,0,6,37,0,37,3,47,32,15,12,1,10,6,4,"weekend"
2017-05-21 03:00:00,2017-05-21,3,3,1,2,5,0,16,7,1,12,4,0,4,9,0,9,0,39,24,15,3,3,8,4,4,"weekend"
2017-05-21 04:00:00,2017-05-21,4,5,4,1,10,1,8,3,4,6,0,0,0,5,0,5,0,19,11,8,3,2,3,1,2,"weekend"
2017-05-21 05:00:00,2017-05-21,5,5,3,2,6,1,6,5,2,5,9,2,7,4,0,4,0,18,10,8,5,6,10,4,6,"weekend"
2017-05-21 06:00:00,2017-05-21,6,8,6,2,21,4,9,18,10,6,13,2,11,12,1,11,2,19,9,10,15,6,10,1,9,"weekend"
2017-05-21 07:00:00,2017-05-21,7,12,10,2,31,2,18,18,15,12,28,4,24,17,5,12,1,30,17,13,24,6,25,4,21,"weekend"
2017-05-21 08:00:00,2017-05-21,8,23,16,7,44,3,24,19,27,7,49,4,45,40,4,36,11,62,29,33,42,12,48,9,39,"weekend"
2017-05-21 09:00:00,2017-05-21,9,58,33,25,72,7,38,41,33,32,108,15,93,72,9,63,34,116,51,65,84,24,66,12,54,"weekend"
2017-05-21 10:00:00,2017-05-21,10,73,44,29,113,10,71,61,84,60,130,31,99,103,19,84,67,194,88,106,119,37,103,19,84,"weekend"
2017-05-21 11:00:00,2017-05-21,11,90,53,37,194,26,100,98,63,95,232,50,182,209,28,181,92,293,135,158,219,66,148,28,120,"weekend"
2017-05-21 12:00:00,2017-05-21,12,140,90,50,282,38,155,122,121,78,408,113,295,270,38,232,188,362,173,189,337,93,200,27,173,"weekend"
2017-05-21 13:00:00,2017-05-21,13,165,106,59,258,36,225,157,132,112,838,397,441,393,85,308,249,415,213,202,367,110,247,41,206,"weekend"
2017-05-21 14:00:00,2017-05-21,14,194,134,60,275,33,177,170,126,74,759,358,401,391,56,335,235,466,235,231,367,98,224,34,190,"weekend"
2017-05-21 15:00:00,2017-05-21,15,140,82,58,285,23,157,145,143,139,654,287,367,361,50,311,222,442,275,167,319,84,212,31,181,"weekend"
2017-05-21 16:00:00,2017-05-21,16,205,115,90,263,28,131,170,122,89,442,77,365,318,31,287,205,425,230,195,345,72,223,47,176,"weekend"
2017-05-21 17:00:00,2017-05-21,17,167,103,64,297,28,154,141,167,119,335,29,306,339,19,320,169,388,213,175,304,104,228,36,192,"weekend"
2017-05-21 18:00:00,2017-05-21,18,160,109,51,291,36,150,177,138,90,357,18,339,330,14,316,196,391,232,159,333,109,249,44,205,"weekend"
2017-05-21 19:00:00,2017-05-21,19,182,115,67,228,19,103,148,122,74,223,9,214,276,10,266,103,352,226,126,253,87,206,27,179,"weekend"
2017-05-21 20:00:00,2017-05-21,20,125,80,45,216,28,73,107,102,53,132,4,128,171,6,165,67,363,225,138,189,57,180,48,132,"weekend"
2017-05-21 21:00:00,2017-05-21,21,62,46,16,127,15,56,58,75,57,77,5,72,78,2,76,9,230,149,81,108,30,81,20,61,"weekend"
2017-05-21 22:00:00,2017-05-21,22,30,17,13,51,1,40,31,30,27,31,3,28,35,2,33,6,144,101,43,46,9,23,9,14,"weekend"
2017-05-21 23:00:00,2017-05-21,23,17,6,11,31,0,9,12,25,18,9,2,7,18,2,16,1,47,36,11,28,3,16,6,10,"weekend"
2017-05-22 00:00:00,2017-05-22,0,10,4,6,17,2,5,4,7,8,5,0,5,4,0,4,1,32,16,16,13,2,4,1,3,"roboczy"
2017-05-22 01:00:00,2017-05-22,1,3,0,3,4,0,1,3,2,6,2,0,2,4,0,4,1,17,14,3,7,0,5,2,3,"roboczy"
2017-05-22 02:00:00,2017-05-22,2,3,3,0,1,0,1,2,8,2,0,0,0,0,0,0,2,12,7,5,2,0,2,0,2,"roboczy"
2017-05-22 03:00:00,2017-05-22,3,0,0,0,5,1,0,2,2,3,0,0,0,0,0,0,4,1,1,0,4,1,3,1,2,"roboczy"
2017-05-22 04:00:00,2017-05-22,4,1,1,0,4,0,2,5,5,1,3,0,3,0,0,0,2,17,8,9,5,2,1,1,0,"roboczy"
2017-05-22 05:00:00,2017-05-22,5,10,5,5,24,5,6,21,14,6,12,1,11,19,0,19,0,31,17,14,27,12,16,2,14,"roboczy"
2017-05-22 06:00:00,2017-05-22,6,34,27,7,136,17,33,83,47,35,66,6,60,58,1,57,2,138,66,72,120,30,108,21,87,"roboczy"
2017-05-22 07:00:00,2017-05-22,7,92,56,36,436,31,123,178,110,99,128,17,111,111,10,101,10,406,199,207,226,54,302,60,242,"roboczy"
2017-05-22 08:00:00,2017-05-22,8,101,78,23,568,24,172,148,117,148,121,14,107,149,6,143,25,700,350,350,227,48,93,0,93,"roboczy"
2017-05-22 09:00:00,2017-05-22,9,71,44,27,221,7,102,83,74,110,68,9,59,70,5,65,17,267,36,231,131,26,161,0,161,"roboczy"
2017-05-22 10:00:00,2017-05-22,10,55,26,29,178,11,76,58,61,73,51,4,47,54,2,52,19,250,134,116,86,24,125,34,91,"roboczy"
2017-05-22 11:00:00,2017-05-22,11,46,26,20,182,5,45,72,49,57,14,8,6,48,5,43,25,232,121,111,73,22,91,24,67,"roboczy"
2017-05-22 12:00:00,2017-05-22,12,52,30,22,166,10,61,69,76,70,73,11,62,68,4,64,30,218,108,110,103,44,115,32,83,"roboczy"
2017-05-22 13:00:00,2017-05-22,13,55,30,25,177,14,63,72,57,77,75,11,64,52,5,47,32,254,115,139,109,36,105,31,74,"roboczy"
2017-05-22 14:00:00,2017-05-22,14,80,44,36,184,13,78,81,75,89,76,14,62,77,7,70,29,310,172,138,125,50,115,37,78,"roboczy"
2017-05-22 15:00:00,2017-05-22,15,118,65,53,253,19,130,114,114,136,125,27,98,134,11,123,30,408,216,192,187,56,201,38,163,"roboczy"
2017-05-22 16:00:00,2017-05-22,16,148,104,44,524,28,278,195,162,179,294,105,189,203,17,186,64,726,386,340,353,100,377,79,298,"roboczy"
2017-05-22 17:00:00,2017-05-22,17,228,144,84,610,29,304,183,137,178,328,121,207,287,15,272,87,833,461,372,357,104,441,80,361,"roboczy"
2017-05-22 18:00:00,2017-05-22,18,229,156,73,454,34,227,184,136,138,263,46,217,261,7,254,114,573,312,261,324,137,370,62,308,"roboczy"
2017-05-22 19:00:00,2017-05-22,19,251,162,89,350,38,179,173,139,116,250,11,239,278,7,271,94,488,290,198,266,122,296,51,245,"roboczy"
2017-05-22 20:00:00,2017-05-22,20,170,105,65,271,24,117,99,112,72,175,4,171,217,3,214,66,407,255,152,202,83,221,50,171,"roboczy"
2017-05-22 21:00:00,2017-05-22,21,124,84,40,147,7,72,91,76,74,107,5,102,138,2,136,20,266,174,92,121,32,135,35,100,"roboczy"
2017-05-22 22:00:00,2017-05-22,22,55,40,15,74,3,52,45,36,39,56,2,54,69,1,68,7,185,123,62,80,11,68,18,50,"roboczy"
2017-05-22 23:00:00,2017-05-22,23,21,10,11,38,3,26,25,20,21,15,1,14,31,2,29,3,67,50,17,27,8,27,6,21,"roboczy"
2017-05-23 00:00:00,2017-05-23,0,16,8,8,10,0,10,4,14,11,7,1,6,12,0,12,0,40,21,19,8,1,9,1,8,"roboczy"
2017-05-23 01:00:00,2017-05-23,1,1,1,0,3,0,5,6,7,8,2,1,1,7,0,7,0,23,17,6,5,0,6,4,2,"roboczy"
2017-05-23 02:00:00,2017-05-23,2,2,0,2,3,0,1,0,2,1,4,0,4,1,0,1,0,10,6,4,2,0,4,1,3,"roboczy"
2017-05-23 03:00:00,2017-05-23,3,2,1,1,3,1,0,3,5,3,6,0,6,0,0,0,0,12,8,4,0,2,1,1,0,"roboczy"
2017-05-23 04:00:00,2017-05-23,4,2,2,0,10,0,1,5,6,4,6,0,6,2,0,2,2,5,3,2,6,1,3,2,1,"roboczy"
2017-05-23 05:00:00,2017-05-23,5,18,12,6,23,7,8,35,21,7,17,2,15,24,0,24,1,32,17,15,38,20,19,2,17,"roboczy"
2017-05-23 06:00:00,2017-05-23,6,50,36,14,160,13,46,98,55,38,83,11,72,77,5,72,7,148,78,70,152,42,124,23,101,"roboczy"
2017-05-23 07:00:00,2017-05-23,7,119,86,33,471,32,128,194,123,115,143,23,120,143,12,131,9,517,274,243,258,67,320,67,253,"roboczy"
2017-05-23 08:00:00,2017-05-23,8,49,7,42,617,20,96,160,131,174,129,21,108,178,11,167,17,699,338,361,252,41,398,80,318,"roboczy"
2017-05-23 09:00:00,2017-05-23,9,79,50,29,340,14,119,3,19,116,89,14,75,97,9,88,24,489,265,224,162,23,231,56,175,"roboczy"
2017-05-23 10:00:00,2017-05-23,10,53,32,21,186,7,65,60,55,68,94,17,77,10,5,5,26,240,129,111,99,31,131,35,96,"roboczy"
2017-05-23 11:00:00,2017-05-23,11,59,34,25,150,19,54,65,74,25,74,22,52,54,7,47,21,259,139,120,78,40,127,49,78,"roboczy"
2017-05-23 12:00:00,2017-05-23,12,71,32,39,159,21,75,54,68,61,81,17,64,71,13,58,21,245,116,129,82,49,115,30,85,"roboczy"
2017-05-23 13:00:00,2017-05-23,13,68,44,24,162,17,80,82,76,83,113,23,90,87,13,74,25,277,159,118,120,33,118,39,79,"roboczy"
2017-05-23 14:00:00,2017-05-23,14,82,48,34,191,8,118,89,76,94,96,34,62,94,11,83,36,292,155,137,125,44,137,39,98,"roboczy"
2017-05-23 15:00:00,2017-05-23,15,116,58,58,296,28,145,118,119,127,175,62,113,164,15,149,35,437,214,223,220,61,229,44,185,"roboczy"
2017-05-23 16:00:00,2017-05-23,16,163,105,58,559,29,285,180,147,201,405,198,207,256,28,228,41,777,441,336,340,107,413,76,337,"roboczy"
2017-05-23 17:00:00,2017-05-23,17,214,138,76,660,30,287,197,174,187,430,190,240,318,23,295,90,832,437,395,367,106,491,71,420,"roboczy"
2017-05-23 18:00:00,2017-05-23,18,211,132,79,481,29,245,176,139,133,340,79,261,259,9,250,104,607,308,299,318,120,392,71,321,"roboczy"
2017-05-23 19:00:00,2017-05-23,19,223,147,76,392,39,193,166,125,124,333,54,279,280,6,274,110,563,335,228,263,130,306,43,263,"roboczy"
2017-05-23 20:00:00,2017-05-23,20,181,127,54,239,22,142,147,132,98,188,13,175,259,9,250,112,383,234,149,236,113,240,50,190,"roboczy"
2017-05-23 21:00:00,2017-05-23,21,119,67,52,171,17,95,91,75,85,133,9,124,183,6,177,21,349,223,126,144,69,148,38,110,"roboczy"
2017-05-23 22:00:00,2017-05-23,22,70,44,26,96,6,57,57,56,72,61,3,58,89,1,88,12,236,158,78,98,32,88,21,67,"roboczy"
2017-05-23 23:00:00,2017-05-23,23,22,13,9,32,1,25,22,25,20,33,1,32,35,0,35,7,109,81,28,33,10,25,5,20,"roboczy"
2017-05-24 00:00:00,2017-05-24,0,11,4,7,22,1,11,12,12,9,11,0,11,15,0,15,0,46,33,13,29,2,14,1,13,"roboczy"
2017-05-24 01:00:00,2017-05-24,1,4,1,3,6,0,9,8,2,11,3,1,2,9,0,9,1,24,21,3,8,2,3,1,2,"roboczy"
2017-05-24 02:00:00,2017-05-24,2,2,1,1,1,1,4,2,2,3,2,1,1,0,0,0,0,15,14,1,3,1,3,2,1,"roboczy"
2017-05-24 03:00:00,2017-05-24,3,3,3,0,1,1,2,4,5,2,0,0,0,2,0,2,0,5,2,3,3,1,1,0,1,"roboczy"
2017-05-24 04:00:00,2017-05-24,4,1,1,0,10,0,3,1,5,5,2,0,2,2,0,2,0,16,9,7,3,1,3,1,2,"roboczy"
2017-05-24 05:00:00,2017-05-24,5,13,9,4,16,7,5,20,12,13,17,3,14,20,2,18,0,28,12,16,27,15,15,6,9,"roboczy"
2017-05-24 06:00:00,2017-05-24,6,32,23,9,124,15,27,80,36,31,66,9,57,77,4,73,1,129,60,69,108,40,100,14,86,"roboczy"
2017-05-24 07:00:00,2017-05-24,7,82,56,26,360,32,105,158,102,92,106,17,89,98,6,92,10,380,195,185,189,51,240,58,182,"roboczy"
2017-05-24 08:00:00,2017-05-24,8,74,48,26,487,19,149,117,83,134,89,12,77,114,10,104,18,530,262,268,181,33,310,62,248,"roboczy"
2017-05-24 09:00:00,2017-05-24,9,46,23,23,224,6,85,56,59,89,63,8,55,56,6,50,9,341,178,163,100,18,180,43,137,"roboczy"
2017-05-24 10:00:00,2017-05-24,10,31,18,13,109,8,44,50,44,66,45,10,35,33,6,27,5,193,95,98,53,18,77,18,59,"roboczy"
2017-05-24 11:00:00,2017-05-24,11,19,11,8,56,11,17,19,26,25,26,11,15,27,7,20,6,98,62,36,39,22,22,10,12,"roboczy"
2017-05-24 12:00:00,2017-05-24,12,14,6,8,38,0,15,11,15,15,22,12,10,20,9,11,0,73,37,36,24,3,29,8,21,"roboczy"
2017-05-24 13:00:00,2017-05-24,13,18,11,7,67,4,25,25,25,39,23,13,10,29,9,20,6,124,53,71,38,8,50,15,35,"roboczy"
2017-05-24 14:00:00,2017-05-24,14,41,26,15,121,10,41,48,60,75,44,21,23,28,10,18,3,211,109,102,71,19,68,19,49,"roboczy"
2017-05-24 15:00:00,2017-05-24,15,76,47,29,201,16,78,91,79,96,116,39,77,100,12,88,10,322,169,153,121,39,140,25,115,"roboczy"
2017-05-24 16:00:00,2017-05-24,16,81,57,24,261,11,137,137,126,122,200,99,101,105,19,86,8,426,252,174,191,47,184,49,135,"roboczy"
2017-05-24 17:00:00,2017-05-24,17,77,58,19,279,14,107,107,86,81,226,154,72,86,15,71,12,372,198,174,161,54,201,36,165,"roboczy"
2017-05-24 18:00:00,2017-05-24,18,62,42,20,149,10,111,72,50,84,137,85,52,67,13,54,10,258,145,113,88,37,106,16,90,"roboczy"
2017-05-24 19:00:00,2017-05-24,19,43,20,23,97,9,43,58,59,42,45,20,25,40,4,36,8,170,91,79,75,32,64,15,49,"roboczy"
2017-05-24 20:00:00,2017-05-24,20,46,25,21,65,4,37,48,53,34,34,10,24,40,8,32,12,123,64,59,50,20,59,15,44,"roboczy"
2017-05-24 21:00:00,2017-05-24,21,29,18,11,43,1,16,35,45,29,19,3,16,26,2,24,0,99,56,43,36,5,46,14,32,"roboczy"
2017-05-24 22:00:00,2017-05-24,22,11,8,3,30,0,17,12,16,13,14,5,9,17,1,16,2,77,46,31,31,6,20,6,14,"roboczy"
2017-05-24 23:00:00,2017-05-24,23,10,7,3,10,0,10,7,8,6,8,3,5,6,3,3,0,21,12,9,10,1,11,5,6,"roboczy"
2017-05-25 00:00:00,2017-05-25,0,3,1,2,7,0,2,7,10,8,4,1,3,4,1,3,0,17,6,11,6,1,4,0,4,"roboczy"
2017-05-25 01:00:00,2017-05-25,1,4,2,2,5,1,3,3,4,3,2,1,1,1,0,1,0,15,8,7,1,1,1,0,1,"roboczy"
2017-05-25 02:00:00,2017-05-25,2,0,0,0,8,0,5,1,1,0,0,0,0,0,0,0,0,7,6,1,1,1,5,1,4,"roboczy"
2017-05-25 03:00:00,2017-05-25,3,0,0,0,4,0,1,1,1,5,0,0,0,0,0,0,0,3,1,2,5,1,0,0,0,"roboczy"
2017-05-25 04:00:00,2017-05-25,4,5,3,2,4,0,1,4,4,0,2,0,2,0,0,0,4,7,5,2,5,1,2,2,0,"roboczy"
2017-05-25 05:00:00,2017-05-25,5,8,6,2,15,3,5,23,15,10,17,3,14,17,1,16,2,31,15,16,22,16,14,2,12,"roboczy"
2017-05-25 06:00:00,2017-05-25,6,38,30,8,127,15,29,79,41,31,63,11,52,71,6,65,0,105,47,58,114,40,87,13,74,"roboczy"
2017-05-25 07:00:00,2017-05-25,7,104,69,35,379,21,104,157,101,95,135,30,105,112,12,100,5,397,209,188,219,50,261,61,200,"roboczy"
2017-05-25 08:00:00,2017-05-25,8,97,76,21,516,17,165,145,103,144,133,26,107,123,9,114,18,596,280,316,197,31,338,75,263,"roboczy"
2017-05-25 09:00:00,2017-05-25,9,61,39,22,304,12,106,79,76,92,78,12,66,69,7,62,14,411,183,228,126,32,212,54,158,"roboczy"
2017-05-25 10:00:00,2017-05-25,10,42,31,11,202,10,67,66,46,84,62,15,47,48,4,44,10,243,128,115,79,19,131,37,94,"roboczy"
2017-05-25 11:00:00,2017-05-25,11,56,37,19,170,8,63,70,73,74,86,23,63,59,4,55,24,248,126,122,99,31,100,25,75,"roboczy"
2017-05-25 12:00:00,2017-05-25,12,60,40,20,149,12,65,67,86,81,86,17,69,52,6,46,22,238,118,120,109,45,153,48,105,"roboczy"
2017-05-25 13:00:00,2017-05-25,13,67,36,31,169,19,73,67,70,103,93,14,79,76,4,72,51,309,146,163,115,48,131,48,83,"roboczy"
2017-05-25 14:00:00,2017-05-25,14,62,38,24,159,25,88,88,71,108,127,41,86,91,8,83,39,315,163,152,112,60,118,27,91,"roboczy"
2017-05-25 15:00:00,2017-05-25,15,102,63,39,268,24,127,139,116,120,160,48,112,159,9,150,31,423,208,215,202,73,240,43,197,"roboczy"
2017-05-25 16:00:00,2017-05-25,16,142,104,38,492,25,255,180,142,202,259,88,171,213,16,197,56,637,310,327,308,98,341,54,287,"roboczy"
2017-05-25 17:00:00,2017-05-25,17,162,106,56,580,23,243,204,163,181,267,55,212,249,7,242,63,723,362,361,312,91,446,79,367,"roboczy"
2017-05-25 18:00:00,2017-05-25,18,219,128,91,442,32,217,172,132,141,265,38,227,238,6,232,105,540,274,266,262,102,326,57,269,"roboczy"
2017-05-25 19:00:00,2017-05-25,19,205,126,79,303,29,171,141,159,105,269,9,260,296,3,293,83,443,226,217,248,126,259,45,214,"roboczy"
2017-05-25 20:00:00,2017-05-25,20,173,108,65,239,22,132,122,119,89,202,8,194,282,7,275,75,396,233,163,207,87,188,32,156,"roboczy"
2017-05-25 21:00:00,2017-05-25,21,82,50,32,152,13,91,104,82,90,98,4,94,155,2,153,24,257,153,104,129,58,88,18,70,"roboczy"
2017-05-25 22:00:00,2017-05-25,22,38,22,16,86,6,54,47,45,43,66,3,63,90,0,90,13,187,126,61,113,17,73,16,57,"roboczy"
2017-05-25 23:00:00,2017-05-25,23,33,21,12,34,3,30,25,25,21,40,4,36,48,0,48,1,109,76,33,36,9,31,9,22,"roboczy"
2017-05-26 00:00:00,2017-05-26,0,9,3,6,24,5,15,13,17,13,7,0,7,13,0,13,0,72,46,26,12,10,14,2,12,"roboczy"
2017-05-26 01:00:00,2017-05-26,1,0,0,0,13,1,7,5,1,8,4,1,3,8,0,8,0,31,22,9,4,1,8,1,7,"roboczy"
2017-05-26 02:00:00,2017-05-26,2,0,0,0,4,0,2,4,3,4,3,1,2,1,0,1,1,10,7,3,0,2,4,2,2,"roboczy"
2017-05-26 03:00:00,2017-05-26,3,0,0,0,8,0,1,3,4,0,1,0,1,0,0,0,1,7,4,3,2,2,0,0,0,"roboczy"
2017-05-26 04:00:00,2017-05-26,4,4,3,1,6,1,0,14,6,3,2,0,2,2,0,2,0,9,6,3,4,1,4,2,2,"roboczy"
2017-05-26 05:00:00,2017-05-26,5,16,9,7,26,6,5,29,15,9,15,4,11,16,0,16,0,22,9,13,32,12,19,6,13,"roboczy"
2017-05-26 06:00:00,2017-05-26,6,38,33,5,132,17,36,89,47,35,60,9,51,62,4,58,3,103,52,51,109,31,96,20,76,"roboczy"
2017-05-26 07:00:00,2017-05-26,7,100,69,31,339,32,113,168,97,87,109,22,87,101,10,91,10,401,220,181,206,63,255,66,189,"roboczy"
2017-05-26 08:00:00,2017-05-26,8,95,74,21,512,12,161,135,101,166,108,18,90,134,12,122,13,601,261,340,191,36,331,85,246,"roboczy"
2017-05-26 09:00:00,2017-05-26,9,60,29,31,292,12,110,79,64,92,90,16,74,69,9,60,18,412,200,212,126,28,207,49,158,"roboczy"
2017-05-26 10:00:00,2017-05-26,10,45,33,12,184,10,59,65,54,52,75,26,49,55,5,50,21,231,112,119,82,24,111,32,79,"roboczy"
2017-05-26 11:00:00,2017-05-26,11,28,8,20,136,2,64,65,40,57,64,18,46,52,8,44,13,200,82,118,61,19,87,32,55,"roboczy"
2017-05-26 12:00:00,2017-05-26,12,43,25,18,102,11,51,43,47,68,68,38,30,44,12,32,12,215,108,107,71,36,80,29,51,"roboczy"
2017-05-26 13:00:00,2017-05-26,13,46,28,18,144,12,57,68,67,91,112,60,52,65,12,53,17,226,98,128,91,43,103,42,61,"roboczy"
2017-05-26 14:00:00,2017-05-26,14,73,40,33,165,15,83,77,73,97,161,113,48,81,14,67,11,266,121,145,136,46,130,28,102,"roboczy"
2017-05-26 15:00:00,2017-05-26,15,90,48,42,250,11,122,132,112,138,207,124,83,136,14,122,13,409,196,213,164,46,182,42,140,"roboczy"
2017-05-26 16:00:00,2017-05-26,16,106,77,29,438,20,188,176,144,161,316,188,128,185,17,168,37,540,278,262,244,69,283,46,237,"roboczy"
2017-05-26 17:00:00,2017-05-26,17,113,74,39,431,18,202,126,119,126,244,120,124,152,8,144,40,537,273,264,228,57,329,82,247,"roboczy"
2017-05-26 18:00:00,2017-05-26,18,91,61,30,216,12,114,111,79,81,183,59,124,80,4,76,33,345,175,170,160,55,150,31,119,"roboczy"
2017-05-26 19:00:00,2017-05-26,19,50,32,18,96,2,86,60,46,59,69,23,46,62,2,60,14,169,83,86,86,35,85,18,67,"roboczy"
2017-05-26 20:00:00,2017-05-26,20,39,26,13,123,12,54,57,66,47,57,8,49,61,4,57,17,175,92,83,105,28,79,7,72,"roboczy"
2017-05-26 21:00:00,2017-05-26,21,38,27,11,72,8,40,55,49,47,59,8,51,59,2,57,8,159,89,70,76,35,59,6,53,"roboczy"
2017-05-26 22:00:00,2017-05-26,22,23,11,12,46,2,30,27,35,24,34,3,31,37,1,36,0,118,74,44,56,12,45,9,36,"roboczy"
2017-05-26 23:00:00,2017-05-26,23,15,9,6,15,1,18,29,31,19,17,1,16,32,0,32,0,73,52,21,20,7,25,9,16,"roboczy"
2017-05-27 00:00:00,2017-05-27,0,14,7,7,21,2,24,12,4,8,7,0,7,31,0,31,2,58,48,10,8,6,12,4,8,"weekend"
2017-05-27 01:00:00,2017-05-27,1,5,4,1,18,0,5,11,5,10,1,0,1,20,0,20,0,26,20,6,16,5,14,2,12,"weekend"
2017-05-27 02:00:00,2017-05-27,2,6,6,0,9,0,4,11,1,4,2,0,2,10,0,10,0,21,16,5,2,0,5,3,2,"weekend"
2017-05-27 03:00:00,2017-05-27,3,2,0,2,5,0,2,4,4,3,1,0,1,7,0,7,0,16,8,8,3,2,3,2,1,"weekend"
2017-05-27 04:00:00,2017-05-27,4,3,1,2,4,0,4,5,3,8,3,0,3,7,0,7,1,21,7,14,3,1,2,1,1,"weekend"
2017-05-27 05:00:00,2017-05-27,5,6,5,1,5,2,4,20,13,5,12,4,8,7,1,6,1,16,11,5,12,11,12,1,11,"weekend"
2017-05-27 06:00:00,2017-05-27,6,10,5,5,22,2,9,24,15,11,21,2,19,18,2,16,9,38,21,17,26,6,17,4,13,"weekend"
2017-05-27 07:00:00,2017-05-27,7,14,10,4,44,3,25,19,28,24,32,8,24,26,3,23,8,45,17,28,46,22,47,8,39,"weekend"
2017-05-27 08:00:00,2017-05-27,8,37,29,8,74,9,20,39,37,31,59,10,49,51,5,46,14,107,60,47,56,20,58,17,41,"weekend"
2017-05-27 09:00:00,2017-05-27,9,38,21,17,95,7,53,45,72,29,106,15,91,82,13,69,21,143,76,67,99,30,89,18,71,"weekend"
2017-05-27 10:00:00,2017-05-27,10,85,62,23,129,13,82,65,69,69,138,27,111,109,11,98,68,176,74,102,162,32,105,23,82,"weekend"
2017-05-27 11:00:00,2017-05-27,11,86,53,33,185,20,98,84,79,77,241,32,209,143,15,128,65,252,123,129,222,73,158,19,139,"weekend"
2017-05-27 12:00:00,2017-05-27,12,154,97,57,264,39,109,127,122,117,300,52,248,213,26,187,123,376,186,190,274,105,198,28,170,"weekend"
2017-05-27 13:00:00,2017-05-27,13,174,107,67,280,29,148,138,154,112,447,150,297,291,36,255,145,376,202,174,297,103,164,23,141,"weekend"
2017-05-27 14:00:00,2017-05-27,14,172,105,67,309,26,151,154,164,125,641,296,345,339,47,292,177,362,187,175,336,120,184,41,143,"weekend"
2017-05-27 15:00:00,2017-05-27,15,210,139,71,285,32,167,122,136,115,771,361,410,435,68,367,184,367,203,164,361,105,172,32,140,"weekend"
2017-05-27 16:00:00,2017-05-27,16,215,137,78,270,39,172,172,144,125,649,233,416,487,38,449,207,383,202,181,410,102,241,38,203,"weekend"
2017-05-27 17:00:00,2017-05-27,17,234,150,84,304,30,170,183,172,137,410,27,383,406,26,380,184,530,286,244,388,121,250,35,215,"weekend"
2017-05-27 18:00:00,2017-05-27,18,240,155,85,253,43,192,160,171,104,419,12,407,393,7,386,209,437,240,197,308,126,272,30,242,"weekend"
2017-05-27 19:00:00,2017-05-27,19,216,140,76,234,39,147,152,115,98,274,5,269,372,4,368,154,420,236,184,282,103,219,29,190,"weekend"
2017-05-27 20:00:00,2017-05-27,20,172,114,58,191,28,146,139,132,90,256,3,253,295,3,292,114,344,221,123,256,86,152,14,138,"weekend"
2017-05-27 21:00:00,2017-05-27,21,120,80,40,138,14,84,77,49,63,153,4,149,194,3,191,28,212,129,83,171,38,93,22,71,"weekend"
2017-05-27 22:00:00,2017-05-27,22,75,38,37,69,7,54,49,50,76,117,3,114,122,1,121,12,228,144,84,109,22,56,11,45,"weekend"
2017-05-27 23:00:00,2017-05-27,23,41,29,12,51,1,36,43,51,44,47,2,45,85,0,85,1,131,91,40,40,9,36,8,28,"weekend"
2017-05-28 00:00:00,2017-05-28,0,15,6,9,40,3,31,28,21,18,31,0,31,54,1,53,0,94,59,35,27,5,15,2,13,"weekend"
2017-05-28 01:00:00,2017-05-28,1,17,8,9,22,2,15,19,20,27,8,0,8,47,0,47,2,115,83,32,17,4,14,1,13,"weekend"
2017-05-28 02:00:00,2017-05-28,2,2,2,0,16,2,12,10,4,26,3,0,3,16,0,16,3,37,25,12,10,4,14,7,7,"weekend"
2017-05-28 03:00:00,2017-05-28,3,3,3,0,9,1,1,7,1,14,10,0,10,10,0,10,4,29,20,9,9,1,4,1,3,"weekend"
2017-05-28 04:00:00,2017-05-28,4,4,4,0,7,0,6,8,4,5,4,0,4,8,0,8,7,18,10,8,2,1,0,0,0,"weekend"
2017-05-28 05:00:00,2017-05-28,5,4,4,0,9,0,4,14,10,3,9,2,7,8,0,8,3,15,10,5,4,3,5,3,2,"weekend"
2017-05-28 06:00:00,2017-05-28,6,10,7,3,16,5,10,21,13,6,10,2,8,14,1,13,3,35,19,16,19,12,19,6,13,"weekend"
2017-05-28 07:00:00,2017-05-28,7,17,10,7,42,2,16,22,23,6,31,4,27,26,5,21,5,32,18,14,41,8,30,13,17,"weekend"
2017-05-28 08:00:00,2017-05-28,8,40,25,15,61,3,27,35,42,17,71,4,67,45,4,41,26,73,34,39,70,20,58,14,44,"weekend"
2017-05-28 09:00:00,2017-05-28,9,68,44,24,77,11,47,49,45,29,126,15,111,70,9,61,70,105,43,62,118,26,88,15,73,"weekend"
2017-05-28 10:00:00,2017-05-28,10,83,49,34,167,26,83,92,62,55,190,31,159,145,19,126,68,187,80,107,148,85,127,25,102,"weekend"
2017-05-28 11:00:00,2017-05-28,11,144,98,46,261,39,127,102,103,83,319,49,270,258,28,230,157,248,109,139,289,94,174,35,139,"weekend"
2017-05-28 12:00:00,2017-05-28,12,189,110,79,349,26,183,136,109,100,525,110,415,371,38,333,283,373,149,224,393,135,257,48,209,"weekend"
2017-05-28 13:00:00,2017-05-28,13,235,141,94,341,32,212,204,166,112,1079,470,609,517,82,435,247,440,175,265,496,134,263,40,223,"weekend"
2017-05-28 14:00:00,2017-05-28,14,210,142,68,418,49,211,193,160,145,1049,445,604,558,71,487,223,497,234,263,470,122,299,38,261,"weekend"
2017-05-28 15:00:00,2017-05-28,15,198,131,67,396,51,220,175,176,154,922,367,555,584,55,529,260,442,233,209,506,145,320,61,259,"weekend"
2017-05-28 16:00:00,2017-05-28,16,267,169,98,428,44,218,188,160,138,717,149,568,567,42,525,282,469,239,230,436,143,340,40,300,"weekend"
2017-05-28 17:00:00,2017-05-28,17,245,129,116,357,47,215,184,167,142,564,29,535,545,19,526,216,494,297,197,487,147,374,64,310,"weekend"
2017-05-28 18:00:00,2017-05-28,18,243,165,78,380,36,159,191,150,117,513,18,495,551,14,537,214,434,238,196,424,146,324,77,247,"weekend"
2017-05-28 19:00:00,2017-05-28,19,228,158,70,325,44,205,163,118,85,383,9,374,436,10,426,220,439,237,202,382,132,302,44,258,"weekend"
2017-05-28 20:00:00,2017-05-28,20,180,129,51,286,30,183,156,152,101,268,4,264,344,6,338,139,416,252,164,316,117,253,35,218,"weekend"
2017-05-28 21:00:00,2017-05-28,21,96,78,18,146,14,67,131,97,75,128,5,123,219,2,217,22,292,211,81,177,56,113,11,102,"weekend"
2017-05-28 22:00:00,2017-05-28,22,49,35,14,82,3,40,60,51,54,72,3,69,90,2,88,14,186,119,67,68,18,56,6,50,"weekend"
2017-05-28 23:00:00,2017-05-28,23,20,16,4,48,3,24,33,45,33,29,2,27,27,2,25,11,106,71,35,69,7,26,3,23,"weekend"
2017-05-29 00:00:00,2017-05-29,0,7,6,1,14,2,11,20,21,22,12,0,12,12,0,12,0,40,28,12,15,7,9,1,8,"roboczy"
2017-05-29 01:00:00,2017-05-29,1,12,9,3,6,0,6,9,9,6,7,0,7,2,0,2,0,19,12,7,10,0,4,1,3,"roboczy"
2017-05-29 02:00:00,2017-05-29,2,1,0,1,2,1,1,3,2,8,1,0,1,2,0,2,0,12,10,2,4,3,1,1,0,"roboczy"
2017-05-29 03:00:00,2017-05-29,3,2,2,0,4,4,0,7,6,5,0,0,0,1,0,1,0,3,1,2,1,3,1,0,1,"roboczy"
2017-05-29 04:00:00,2017-05-29,4,4,3,1,6,1,5,3,2,1,4,0,4,4,0,4,2,9,5,4,8,5,2,1,1,"roboczy"
2017-05-29 05:00:00,2017-05-29,5,11,9,2,20,6,8,37,24,9,9,1,8,26,0,26,4,35,19,16,30,16,13,2,11,"roboczy"
2017-05-29 06:00:00,2017-05-29,6,38,29,9,130,24,32,111,49,41,62,6,56,78,1,77,4,126,78,48,112,37,91,17,74,"roboczy"
2017-05-29 07:00:00,2017-05-29,7,102,70,32,420,28,108,180,109,87,125,17,108,141,10,131,10,406,191,215,231,54,280,72,208,"roboczy"
2017-05-29 08:00:00,2017-05-29,8,111,81,30,589,18,165,145,106,138,128,14,114,136,6,130,24,635,279,356,212,39,380,92,288,"roboczy"
2017-05-29 09:00:00,2017-05-29,9,61,31,30,339,7,101,98,79,117,70,9,61,91,5,86,20,430,212,218,136,26,220,46,174,"roboczy"
2017-05-29 10:00:00,2017-05-29,10,59,32,27,173,5,47,63,57,57,29,4,25,42,2,40,13,246,126,120,73,26,134,25,109,"roboczy"
2017-05-29 11:00:00,2017-05-29,11,41,22,19,152,9,36,68,63,62,43,8,35,38,5,33,12,198,107,91,76,24,103,34,69,"roboczy"
2017-05-29 12:00:00,2017-05-29,12,38,26,12,136,8,48,55,51,69,52,11,41,46,4,42,6,220,125,95,77,29,124,37,87,"roboczy"
2017-05-29 13:00:00,2017-05-29,13,49,27,22,145,15,52,63,57,77,49,11,38,49,5,44,22,250,129,121,109,37,100,23,77,"roboczy"
2017-05-29 14:00:00,2017-05-29,14,53,32,21,166,18,71,90,71,87,95,14,81,74,7,67,29,275,137,138,97,49,127,37,90,"roboczy"
2017-05-29 15:00:00,2017-05-29,15,86,58,28,295,16,133,165,143,130,128,28,100,129,11,118,27,363,195,168,225,54,219,34,185,"roboczy"
2017-05-29 16:00:00,2017-05-29,16,144,110,34,521,32,261,189,159,190,333,141,192,227,22,205,52,656,328,328,304,95,358,63,295,"roboczy"
2017-05-29 17:00:00,2017-05-29,17,192,143,49,561,34,283,225,184,170,335,140,195,271,15,256,65,726,355,371,318,106,423,77,346,"roboczy"
2017-05-29 18:00:00,2017-05-29,18,243,151,92,426,28,193,147,144,116,276,77,199,239,7,232,93,525,253,272,298,103,340,69,271,"roboczy"
2017-05-29 19:00:00,2017-05-29,19,183,127,56,294,38,145,168,154,104,244,11,233,282,7,275,110,422,218,204,262,126,269,50,219,"roboczy"
2017-05-29 20:00:00,2017-05-29,20,154,101,53,306,27,127,111,103,114,205,4,201,255,3,252,85,351,186,165,226,115,241,47,194,"roboczy"
2017-05-29 21:00:00,2017-05-29,21,110,74,36,172,21,105,94,74,62,139,5,134,189,2,187,41,291,188,103,160,69,150,19,131,"roboczy"
2017-05-29 22:00:00,2017-05-29,22,75,54,21,91,8,51,47,64,49,75,2,73,90,1,89,8,201,133,68,81,27,68,4,64,"roboczy"
2017-05-29 23:00:00,2017-05-29,23,27,16,11,34,2,21,26,30,32,28,1,27,52,2,50,3,102,67,35,44,10,21,3,18,"roboczy"
2017-05-30 00:00:00,2017-05-30,0,10,1,9,11,2,8,15,23,8,13,1,12,10,0,10,0,58,38,20,13,4,18,4,14,"roboczy"
2017-05-30 01:00:00,2017-05-30,1,4,2,2,5,1,7,5,8,2,3,1,2,8,0,8,0,34,21,13,5,1,11,0,11,"roboczy"
2017-05-30 02:00:00,2017-05-30,2,5,2,3,3,0,1,6,3,5,0,0,0,1,0,1,0,12,9,3,3,0,3,1,2,"roboczy"
2017-05-30 03:00:00,2017-05-30,3,2,2,0,0,4,2,4,6,2,0,0,0,2,0,2,1,6,3,3,4,4,1,0,1,"roboczy"
2017-05-30 04:00:00,2017-05-30,4,3,1,2,5,1,1,8,7,3,2,0,2,3,0,3,0,14,9,5,4,5,4,2,2,"roboczy"
2017-05-30 05:00:00,2017-05-30,5,21,14,7,30,7,15,41,12,12,10,2,8,27,0,27,3,32,15,17,40,17,18,4,14,"roboczy"
2017-05-30 06:00:00,2017-05-30,6,55,38,17,178,14,46,117,66,48,76,11,65,73,5,68,5,157,72,85,138,36,131,24,107,"roboczy"
2017-05-30 07:00:00,2017-05-30,7,137,100,37,456,30,137,220,125,112,160,23,137,166,12,154,8,464,232,232,282,76,353,96,257,"roboczy"
2017-05-30 08:00:00,2017-05-30,8,128,93,35,659,24,217,159,126,150,169,21,148,173,11,162,27,718,313,405,281,54,455,92,363,"roboczy"
2017-05-30 09:00:00,2017-05-30,9,84,51,33,321,9,120,104,89,121,120,14,106,106,9,97,15,479,237,242,176,29,214,46,168,"roboczy"
2017-05-30 10:00:00,2017-05-30,10,66,35,31,191,8,73,84,65,73,84,17,67,60,5,55,22,262,125,137,100,39,154,47,107,"roboczy"
2017-05-30 11:00:00,2017-05-30,11,62,38,24,153,20,59,80,60,48,85,22,63,67,7,60,22,226,101,125,87,39,120,40,80,"roboczy"
2017-05-30 12:00:00,2017-05-30,12,57,33,24,168,13,73,59,80,79,70,17,53,75,13,62,39,255,125,130,110,39,105,24,81,"roboczy"
2017-05-30 13:00:00,2017-05-30,13,50,27,23,171,10,70,59,75,76,101,23,78,85,13,72,19,277,145,132,86,37,121,38,83,"roboczy"
2017-05-30 14:00:00,2017-05-30,14,86,51,35,192,18,83,102,86,98,111,34,77,94,11,83,26,338,173,165,175,46,160,35,125,"roboczy"
2017-05-30 15:00:00,2017-05-30,15,130,76,54,339,20,139,141,126,110,287,135,152,170,15,155,46,402,197,205,219,72,243,44,199,"roboczy"
2017-05-30 16:00:00,2017-05-30,16,161,106,55,581,37,296,227,178,196,435,241,194,263,38,225,63,774,368,406,401,123,408,61,347,"roboczy"
2017-05-30 17:00:00,2017-05-30,17,238,172,66,683,36,299,238,168,168,544,235,309,314,23,291,99,793,368,425,379,120,494,83,411,"roboczy"
2017-05-30 18:00:00,2017-05-30,18,273,177,96,496,41,256,208,156,133,410,107,303,324,9,315,92,631,303,328,400,151,410,73,337,"roboczy"
2017-05-30 19:00:00,2017-05-30,19,241,153,88,355,42,164,176,158,125,324,26,298,357,6,351,148,477,200,277,330,144,287,55,232,"roboczy"
2017-05-30 20:00:00,2017-05-30,20,192,129,63,296,33,155,136,151,95,263,13,250,338,9,329,90,385,209,176,219,131,298,41,257,"roboczy"
2017-05-30 21:00:00,2017-05-30,21,143,88,55,195,20,112,104,102,71,151,9,142,190,6,184,33,273,159,114,161,68,156,15,141,"roboczy"
2017-05-30 22:00:00,2017-05-30,22,57,38,19,100,6,60,68,63,63,87,3,84,123,1,122,18,230,146,84,94,36,58,9,49,"roboczy"
2017-05-30 23:00:00,2017-05-30,23,28,17,11,40,3,31,29,39,35,38,1,37,39,0,39,2,106,67,39,43,5,38,5,33,"roboczy"
2017-05-31 00:00:00,2017-05-31,0,20,11,9,11,2,21,14,6,12,16,0,16,15,0,15,0,51,41,10,21,5,12,3,9,"roboczy"
2017-05-31 01:00:00,2017-05-31,1,6,4,2,6,0,7,0,5,13,6,1,5,4,0,4,0,22,15,7,8,2,5,2,3,"roboczy"
2017-05-31 02:00:00,2017-05-31,2,2,1,1,0,0,0,4,1,11,1,1,0,5,0,5,0,17,11,6,3,0,5,1,4,"roboczy"
2017-05-31 03:00:00,2017-05-31,3,2,1,1,1,1,1,6,4,2,1,0,1,0,0,0,0,14,7,7,2,1,0,0,0,"roboczy"
2017-05-31 04:00:00,2017-05-31,4,3,1,2,11,3,0,4,4,2,4,0,4,3,0,3,0,10,3,7,2,6,3,0,3,"roboczy"
2017-05-31 05:00:00,2017-05-31,5,9,6,3,19,5,8,28,14,5,16,3,13,23,2,21,2,29,16,13,27,11,21,6,15,"roboczy"
2017-05-31 06:00:00,2017-05-31,6,45,30,15,131,15,34,94,48,34,61,9,52,63,4,59,7,121,62,59,110,42,110,24,86,"roboczy"
2017-05-31 07:00:00,2017-05-31,7,93,61,32,376,31,102,170,101,98,113,17,96,118,6,112,8,405,203,202,234,53,266,79,187,"roboczy"
2017-05-31 08:00:00,2017-05-31,8,115,82,33,534,16,175,136,108,142,112,12,100,120,10,110,11,606,254,352,188,40,379,72,307,"roboczy"
2017-05-31 09:00:00,2017-05-31,9,50,33,17,304,6,97,77,62,103,89,8,81,78,6,72,13,380,181,199,115,24,207,46,161,"roboczy"
2017-05-31 10:00:00,2017-05-31,10,37,26,11,144,6,40,55,52,63,51,10,41,47,6,41,3,208,89,119,80,23,123,37,86,"roboczy"
2017-05-31 11:00:00,2017-05-31,11,48,27,21,138,14,40,55,47,59,81,11,70,35,7,28,9,207,101,106,59,22,88,23,65,"roboczy"
2017-05-31 12:00:00,2017-05-31,12,41,26,15,125,6,50,47,56,59,66,12,54,53,9,44,5,214,100,114,66,17,109,42,67,"roboczy"
2017-05-31 13:00:00,2017-05-31,13,36,17,19,145,7,54,48,49,82,54,13,41,34,9,25,8,210,117,93,90,19,88,31,57,"roboczy"
2017-05-31 14:00:00,2017-05-31,14,52,28,24,117,12,50,65,57,67,63,21,42,61,10,51,21,257,132,125,101,25,105,34,71,"roboczy"
2017-05-31 15:00:00,2017-05-31,15,93,49,44,227,20,120,105,94,105,97,37,60,114,12,102,22,341,154,187,175,45,194,47,147,"roboczy"
2017-05-31 16:00:00,2017-05-31,16,106,73,33,427,22,206,144,107,172,227,113,114,173,19,154,25,603,299,304,241,56,326,69,257,"roboczy"
2017-05-31 17:00:00,2017-05-31,17,136,95,41,506,19,226,175,188,153,320,173,147,186,15,171,49,672,341,331,262,78,382,68,314,"roboczy"
2017-05-31 18:00:00,2017-05-31,18,163,112,51,394,27,182,152,126,117,215,60,155,226,13,213,54,511,215,296,218,85,277,46,231,"roboczy"
2017-05-31 19:00:00,2017-05-31,19,175,116,59,300,24,145,128,102,113,176,20,156,214,4,210,87,407,217,190,183,78,236,40,196,"roboczy"
2017-05-31 20:00:00,2017-05-31,20,141,87,54,241,16,111,105,93,77,153,10,143,222,8,214,44,346,176,170,162,55,206,41,165,"roboczy"
2017-05-31 21:00:00,2017-05-31,21,118,79,39,149,13,91,78,82,56,83,3,80,157,2,155,15,240,145,95,103,51,99,18,81,"roboczy"
2017-05-31 22:00:00,2017-05-31,22,45,31,14,65,6,65,36,51,43,77,5,72,100,1,99,1,181,117,64,79,19,59,2,57,"roboczy"
2017-05-31 23:00:00,2017-05-31,23,31,16,15,49,3,20,24,28,25,30,3,27,41,3,38,3,105,68,37,40,8,24,4,20,"roboczy"
2017-06-01 00:00:00,2017-06-01,0,11,8,3,15,5,7,16,14,17,NA,1,NA,9,1,8,0,62,39,23,10,10,17,3,14,"roboczy"
2017-06-01 01:00:00,2017-06-01,1,2,2,0,8,1,2,8,6,3,NA,1,NA,5,0,5,0,23,12,11,8,2,6,2,4,"roboczy"
2017-06-01 02:00:00,2017-06-01,2,2,0,2,4,0,0,0,3,1,NA,0,NA,3,0,3,0,10,6,4,1,0,1,0,1,"roboczy"
2017-06-01 03:00:00,2017-06-01,3,3,2,1,4,1,0,3,3,1,NA,0,NA,1,0,1,1,6,3,3,3,1,1,0,1,"roboczy"
2017-06-01 04:00:00,2017-06-01,4,1,1,0,7,2,0,8,5,2,NA,0,NA,2,0,2,0,5,3,2,5,4,4,2,2,"roboczy"
2017-06-01 05:00:00,2017-06-01,5,16,11,5,26,5,6,29,11,6,NA,3,NA,22,1,21,0,23,8,15,26,11,13,2,11,"roboczy"
2017-06-01 06:00:00,2017-06-01,6,39,29,10,153,16,31,89,42,31,NA,11,NA,80,6,74,4,129,61,68,131,31,110,16,94,"roboczy"
2017-06-01 07:00:00,2017-06-01,7,89,66,23,392,25,131,189,118,104,NA,31,NA,134,12,122,11,429,202,227,235,60,270,67,203,"roboczy"
2017-06-01 08:00:00,2017-06-01,8,85,65,20,523,22,165,137,91,113,NA,27,NA,125,9,116,17,541,232,309,208,35,349,82,267,"roboczy"
2017-06-01 09:00:00,2017-06-01,9,58,36,22,253,11,120,79,67,87,NA,12,NA,64,7,57,12,371,170,201,113,19,174,33,141,"roboczy"
2017-06-01 10:00:00,2017-06-01,10,50,28,22,155,7,39,49,57,43,NA,15,NA,69,4,65,30,184,89,95,64,22,94,25,69,"roboczy"
2017-06-01 11:00:00,2017-06-01,11,33,19,14,126,7,36,51,32,63,NA,24,NA,33,4,29,59,184,74,110,78,27,81,24,57,"roboczy"
2017-06-01 12:00:00,2017-06-01,12,43,18,25,141,6,33,42,56,74,NA,18,NA,53,6,47,22,170,84,86,57,11,79,26,53,"roboczy"
2017-06-01 13:00:00,2017-06-01,13,49,30,19,124,6,41,55,51,76,37,14,23,51,4,47,28,240,125,115,86,24,101,29,72,"roboczy"
2017-06-01 14:00:00,2017-06-01,14,52,31,21,164,4,61,65,53,91,94,42,52,49,8,41,9,235,109,126,113,27,99,27,72,"roboczy"
2017-06-01 15:00:00,2017-06-01,15,73,50,23,248,17,125,123,97,93,133,54,79,107,9,98,17,381,185,196,165,41,193,36,157,"roboczy"
2017-06-01 16:00:00,2017-06-01,16,122,92,30,432,16,211,177,113,145,224,105,119,179,21,158,24,538,236,302,263,61,284,59,225,"roboczy"
2017-06-01 17:00:00,2017-06-01,17,142,105,37,500,21,200,173,160,157,210,60,150,188,7,181,41,605,269,336,238,67,353,61,292,"roboczy"
2017-06-01 18:00:00,2017-06-01,18,108,74,34,310,16,147,151,113,110,144,25,119,165,6,159,30,416,206,210,192,61,240,54,186,"roboczy"
2017-06-01 19:00:00,2017-06-01,19,122,75,47,225,7,148,101,92,72,107,9,98,127,3,124,46,341,147,194,109,34,146,25,121,"roboczy"
2017-06-01 20:00:00,2017-06-01,20,92,56,36,170,17,78,89,63,59,79,8,71,134,7,127,36,270,138,132,118,49,124,27,97,"roboczy"
2017-06-01 21:00:00,2017-06-01,21,83,60,23,96,8,49,58,54,71,72,4,68,78,2,76,14,190,91,99,76,28,60,11,49,"roboczy"
2017-06-01 22:00:00,2017-06-01,22,42,26,16,84,6,42,36,45,55,27,3,24,46,0,46,10,136,80,56,60,13,54,6,48,"roboczy"
2017-06-01 23:00:00,2017-06-01,23,8,6,2,29,8,21,16,34,18,37,4,33,31,0,31,0,88,59,29,27,14,16,5,11,"roboczy"
2017-06-02 00:00:00,2017-06-02,0,6,4,2,16,0,13,4,13,12,12,0,12,8,0,8,0,34,24,10,15,3,14,5,9,"roboczy"
2017-06-02 01:00:00,2017-06-02,1,4,2,2,3,1,2,0,3,12,9,1,8,5,0,5,0,18,12,6,7,2,4,1,3,"roboczy"
2017-06-02 02:00:00,2017-06-02,2,3,2,1,7,1,1,2,3,4,1,1,0,0,0,0,0,16,12,4,6,2,2,1,1,"roboczy"
2017-06-02 03:00:00,2017-06-02,3,0,0,0,2,1,0,5,6,2,3,0,3,0,0,0,2,8,6,2,3,1,2,0,2,"roboczy"
2017-06-02 04:00:00,2017-06-02,4,4,2,2,5,1,1,6,4,3,2,0,2,1,0,1,0,9,5,4,10,3,2,0,2,"roboczy"
2017-06-02 05:00:00,2017-06-02,5,4,2,2,13,6,8,22,20,11,14,4,10,19,0,19,4,29,15,14,32,13,10,3,7,"roboczy"
2017-06-02 06:00:00,2017-06-02,6,40,30,10,119,12,33,87,47,32,60,9,51,67,4,63,7,125,61,64,108,37,95,23,72,"roboczy"
2017-06-02 07:00:00,2017-06-02,7,87,64,23,378,23,98,179,108,82,120,22,98,122,10,112,7,367,172,195,214,46,273,72,201,"roboczy"
2017-06-02 08:00:00,2017-06-02,8,106,77,29,510,14,144,126,106,142,111,18,93,119,12,107,20,597,244,353,186,41,359,61,298,"roboczy"
2017-06-02 09:00:00,2017-06-02,9,52,31,21,265,10,74,82,77,99,72,16,56,71,9,62,6,408,188,220,115,26,166,40,126,"roboczy"
2017-06-02 10:00:00,2017-06-02,10,50,33,17,160,13,54,62,54,76,71,27,44,52,5,47,18,241,128,113,107,23,138,37,101,"roboczy"
2017-06-02 11:00:00,2017-06-02,11,45,30,15,152,10,47,78,62,69,76,18,58,59,8,51,22,216,88,128,100,29,86,28,58,"roboczy"
2017-06-02 12:00:00,2017-06-02,12,68,43,25,153,6,65,67,58,77,100,41,59,66,12,54,15,248,108,140,114,29,113,34,79,"roboczy"
2017-06-02 13:00:00,2017-06-02,13,70,40,30,170,16,76,70,86,94,150,62,88,82,12,70,28,248,118,130,135,33,127,43,84,"roboczy"
2017-06-02 14:00:00,2017-06-02,14,68,43,25,199,15,78,110,117,114,234,133,101,93,14,79,19,322,165,157,163,42,155,44,111,"roboczy"
2017-06-02 15:00:00,2017-06-02,15,96,62,34,306,21,130,128,124,120,280,151,129,144,14,130,24,379,162,217,218,57,246,55,191,"roboczy"
2017-06-02 16:00:00,2017-06-02,16,143,87,56,505,15,227,182,159,173,361,214,147,233,16,217,52,621,295,326,263,70,351,55,296,"roboczy"
2017-06-02 17:00:00,2017-06-02,17,166,121,45,455,26,214,182,186,154,373,158,215,265,8,257,66,646,291,355,289,65,338,58,280,"roboczy"
2017-06-02 18:00:00,2017-06-02,18,148,94,54,322,22,170,154,131,143,275,89,186,216,4,212,80,461,198,263,258,68,252,51,201,"roboczy"
2017-06-02 19:00:00,2017-06-02,19,155,100,55,238,32,130,156,127,92,236,24,212,254,2,252,82,356,186,170,267,95,199,28,171,"roboczy"
2017-06-02 20:00:00,2017-06-02,20,124,90,34,172,20,116,144,108,81,219,8,211,235,4,231,94,337,153,184,231,81,162,21,141,"roboczy"
2017-06-02 21:00:00,2017-06-02,21,80,55,25,122,8,64,90,96,67,163,8,155,184,2,182,27,259,127,132,145,55,77,8,69,"roboczy"
2017-06-02 22:00:00,2017-06-02,22,57,37,20,77,9,53,61,58,58,79,3,76,127,1,126,11,220,148,72,103,28,57,3,54,"roboczy"
2017-06-02 23:00:00,2017-06-02,23,41,26,15,38,3,25,25,44,30,34,1,33,101,0,101,8,152,106,46,45,9,28,4,24,"roboczy"
2017-06-03 00:00:00,2017-06-03,0,22,9,13,35,5,40,20,20,23,31,0,31,34,0,34,2,86,52,34,39,11,10,2,8,"weekend"
2017-06-03 01:00:00,2017-06-03,1,7,5,2,13,2,7,12,12,6,5,0,5,21,0,21,1,39,27,12,12,1,5,0,5,"weekend"
2017-06-03 02:00:00,2017-06-03,2,5,4,1,11,0,3,5,4,6,1,0,1,15,0,15,3,33,20,13,4,0,2,2,0,"weekend"
2017-06-03 03:00:00,2017-06-03,3,2,2,0,5,2,5,3,2,5,5,0,5,16,0,16,3,18,13,5,3,5,2,0,2,"weekend"
2017-06-03 04:00:00,2017-06-03,4,4,4,0,5,0,0,3,3,3,1,0,1,1,0,1,5,22,13,9,5,2,1,0,1,"weekend"
2017-06-03 05:00:00,2017-06-03,5,4,4,0,6,1,9,12,6,7,8,4,4,7,1,6,4,15,6,9,12,8,8,3,5,"weekend"
2017-06-03 06:00:00,2017-06-03,6,8,5,3,32,3,15,23,20,11,17,2,15,24,2,22,9,31,13,18,33,19,25,9,16,"weekend"
2017-06-03 07:00:00,2017-06-03,7,15,7,8,51,4,15,31,28,7,39,8,31,28,3,25,10,58,30,28,36,16,43,8,35,"weekend"
2017-06-03 08:00:00,2017-06-03,8,18,13,5,64,3,37,37,42,40,63,10,53,51,5,46,6,93,43,50,58,15,58,12,46,"weekend"
2017-06-03 09:00:00,2017-06-03,9,51,28,23,97,6,42,53,65,37,91,15,76,78,13,65,19,133,62,71,98,35,82,17,65,"weekend"
2017-06-03 10:00:00,2017-06-03,10,60,40,20,129,14,60,82,86,63,119,27,92,115,11,104,38,191,81,110,115,56,90,22,68,"weekend"
2017-06-03 11:00:00,2017-06-03,11,108,70,38,207,15,97,118,117,65,210,32,178,139,15,124,51,238,107,131,203,63,153,37,116,"weekend"
2017-06-03 12:00:00,2017-06-03,12,142,78,64,242,23,119,147,112,116,318,51,267,271,24,247,131,301,116,185,253,65,151,41,110,"weekend"
2017-06-03 13:00:00,2017-06-03,13,125,84,41,259,27,170,139,122,120,503,223,280,273,32,241,163,325,160,165,299,90,206,46,160,"weekend"
2017-06-03 14:00:00,2017-06-03,14,156,108,48,298,35,179,139,170,139,707,348,359,343,54,289,177,391,189,202,328,100,199,28,171,"weekend"
2017-06-03 15:00:00,2017-06-03,15,151,103,48,315,23,194,178,142,119,844,424,420,408,72,336,237,396,193,203,368,81,229,43,186,"weekend"
2017-06-03 16:00:00,2017-06-03,16,170,105,65,281,37,144,177,112,148,638,266,372,394,40,354,159,421,205,216,381,92,235,49,186,"weekend"
2017-06-03 17:00:00,2017-06-03,17,217,155,62,292,26,146,154,147,129,453,27,426,423,23,400,173,477,264,213,321,92,208,45,163,"weekend"
2017-06-03 18:00:00,2017-06-03,18,224,143,81,308,26,161,179,150,148,392,12,380,366,7,359,178,455,230,225,403,99,255,40,215,"weekend"
2017-06-03 19:00:00,2017-06-03,19,175,111,64,288,30,148,164,127,107,310,5,305,322,4,318,123,386,195,191,290,114,209,47,162,"weekend"
2017-06-03 20:00:00,2017-06-03,20,136,92,44,219,22,110,133,121,88,213,3,210,243,3,240,48,316,168,148,207,64,199,49,150,"weekend"
2017-06-03 21:00:00,2017-06-03,21,73,49,24,120,15,64,66,64,40,92,4,88,153,3,150,27,195,118,77,124,45,58,11,47,"weekend"
2017-06-03 22:00:00,2017-06-03,22,41,29,12,68,9,37,70,43,61,60,3,57,97,1,96,6,152,85,67,93,21,35,6,29,"weekend"
2017-06-03 23:00:00,2017-06-03,23,41,33,8,54,4,41,52,42,38,34,2,32,51,0,51,3,124,89,35,26,10,29,4,25,"weekend"
2017-06-04 00:00:00,2017-06-04,0,18,11,7,25,4,15,29,23,23,32,0,32,41,1,40,10,91,64,27,26,13,16,3,13,"weekend"
2017-06-04 01:00:00,2017-06-04,1,11,8,3,20,2,10,4,8,10,8,0,8,19,0,19,0,45,25,20,16,3,9,3,6,"weekend"
2017-06-04 02:00:00,2017-06-04,2,8,5,3,16,0,10,10,9,7,6,0,6,21,0,21,0,40,25,15,6,1,10,1,9,"weekend"
2017-06-04 03:00:00,2017-06-04,3,3,2,1,5,1,4,3,3,6,6,0,6,11,0,11,5,23,7,16,5,2,8,1,7,"weekend"
2017-06-04 04:00:00,2017-06-04,4,0,0,0,14,0,4,1,2,6,3,0,3,2,0,2,7,22,17,5,7,1,7,2,5,"weekend"
2017-06-04 05:00:00,2017-06-04,5,6,5,1,6,1,3,13,8,2,6,2,4,2,0,2,2,19,11,8,6,3,7,1,6,"weekend"
2017-06-04 06:00:00,2017-06-04,6,8,8,0,10,5,7,11,9,7,7,2,5,10,1,9,9,23,16,7,20,9,16,3,13,"weekend"
2017-06-04 07:00:00,2017-06-04,7,7,4,3,23,1,14,19,12,7,23,4,19,27,5,22,8,38,17,21,28,6,23,7,16,"weekend"
2017-06-04 08:00:00,2017-06-04,8,34,23,11,42,6,38,25,27,17,53,4,49,30,4,26,19,71,27,44,56,21,49,11,38,"weekend"
2017-06-04 09:00:00,2017-06-04,9,46,35,11,80,5,53,40,44,33,95,15,80,82,9,73,19,81,32,49,80,28,68,13,55,"weekend"
2017-06-04 10:00:00,2017-06-04,10,98,54,44,177,19,74,80,74,30,179,31,148,123,19,104,87,162,85,77,120,54,130,14,116,"weekend"
2017-06-04 11:00:00,2017-06-04,11,150,103,47,244,31,159,108,102,67,314,49,265,234,28,206,110,276,96,180,297,126,170,22,148,"weekend"
2017-06-04 12:00:00,2017-06-04,12,201,129,72,327,38,176,181,156,67,558,110,448,359,37,322,209,369,154,215,400,132,248,41,207,"weekend"
2017-06-04 13:00:00,2017-06-04,13,216,125,91,407,46,233,171,150,133,1144,590,554,517,97,420,276,422,187,235,513,128,317,42,275,"weekend"
2017-06-04 14:00:00,2017-06-04,14,221,154,67,388,39,220,171,174,144,1056,503,553,558,74,484,287,414,209,205,504,147,285,41,244,"weekend"
2017-06-04 15:00:00,2017-06-04,15,211,131,80,423,41,212,207,179,109,962,397,565,559,59,500,210,443,225,218,490,118,285,31,254,"weekend"
2017-06-04 16:00:00,2017-06-04,16,199,131,68,335,46,187,202,152,151,532,94,438,497,39,458,232,456,239,217,413,110,287,45,242,"weekend"
2017-06-04 17:00:00,2017-06-04,17,179,123,56,249,27,166,102,106,108,211,29,182,238,19,219,61,298,198,100,230,77,182,36,146,"weekend"
2017-06-04 18:00:00,2017-06-04,18,112,79,33,127,14,121,83,79,65,93,18,75,119,14,105,44,188,119,69,140,49,86,22,64,"weekend"
2017-06-04 19:00:00,2017-06-04,19,31,23,8,67,7,37,37,41,36,76,9,67,51,10,41,12,96,60,36,77,20,77,16,61,"weekend"
2017-06-04 20:00:00,2017-06-04,20,26,13,13,45,1,32,44,37,14,25,4,21,34,6,28,1,59,36,23,23,17,36,17,19,"weekend"
2017-06-04 21:00:00,2017-06-04,21,16,9,7,44,3,22,15,28,22,32,5,27,22,2,20,2,72,35,37,19,8,25,4,21,"weekend"
2017-06-04 22:00:00,2017-06-04,22,14,11,3,25,0,20,19,27,28,15,3,12,25,2,23,0,58,32,26,18,5,22,6,16,"weekend"
2017-06-04 23:00:00,2017-06-04,23,9,8,1,12,0,26,7,14,7,6,2,4,13,2,11,0,23,12,11,11,3,6,0,6,"weekend"
2017-06-05 00:00:00,2017-06-05,0,4,3,1,4,1,5,1,3,5,NA,NA,4,NA,NA,3,1,16,9,7,9,1,11,1,10,"roboczy"
2017-06-05 01:00:00,2017-06-05,1,1,1,0,4,0,2,2,6,6,NA,NA,2,NA,NA,6,0,16,12,4,6,1,0,0,0,"roboczy"
2017-06-05 02:00:00,2017-06-05,2,2,1,1,2,0,1,2,2,0,NA,NA,0,NA,NA,0,0,9,7,2,1,0,2,0,2,"roboczy"
2017-06-05 03:00:00,2017-06-05,3,0,0,0,2,2,0,1,2,0,NA,NA,0,NA,NA,0,1,1,1,0,3,5,4,1,3,"roboczy"
2017-06-05 04:00:00,2017-06-05,4,2,1,1,2,1,0,2,3,1,NA,NA,0,NA,NA,3,1,5,0,5,5,3,1,0,1,"roboczy"
2017-06-05 05:00:00,2017-06-05,5,4,4,0,12,3,3,18,25,14,13,0,13,11,0,11,2,29,15,14,28,12,14,3,11,"roboczy"
2017-06-05 06:00:00,2017-06-05,6,35,25,10,124,17,26,78,45,25,42,0,42,47,0,47,2,107,45,62,98,24,79,17,62,"roboczy"
2017-06-05 07:00:00,2017-06-05,7,95,66,29,382,22,110,170,100,96,90,0,90,108,0,108,7,361,159,202,191,45,287,59,228,"roboczy"
2017-06-05 08:00:00,2017-06-05,8,129,86,43,524,11,170,167,91,146,100,0,100,131,0,131,13,577,241,336,202,32,357,70,287,"roboczy"
2017-06-05 09:00:00,2017-06-05,9,89,60,29,341,6,109,98,66,107,66,0,66,80,0,80,12,421,197,224,137,17,241,53,188,"roboczy"
2017-06-05 10:00:00,2017-06-05,10,52,36,16,189,9,76,50,62,61,44,0,44,62,0,62,17,252,110,142,69,25,117,41,76,"roboczy"
2017-06-05 11:00:00,2017-06-05,11,55,33,22,172,6,51,64,59,71,35,0,35,39,22,17,21,260,122,138,72,24,111,41,70,"roboczy"
2017-06-05 12:00:00,2017-06-05,12,53,30,23,171,13,52,70,60,89,81,34,47,112,56,56,24,239,117,122,94,30,97,36,61,"roboczy"
2017-06-05 13:00:00,2017-06-05,13,65,41,24,175,7,67,58,68,82,113,57,56,96,30,66,30,276,127,149,103,34,137,46,91,"roboczy"
2017-06-05 14:00:00,2017-06-05,14,73,44,29,182,19,90,96,97,95,152,66,86,114,53,61,24,252,129,123,105,37,135,54,81,"roboczy"
2017-06-05 15:00:00,2017-06-05,15,99,66,33,309,18,99,103,130,127,213,91,122,181,54,127,33,375,192,183,185,63,213,44,169,"roboczy"
2017-06-05 16:00:00,2017-06-05,16,145,104,41,501,23,235,171,177,176,263,111,152,258,58,200,30,635,283,352,290,74,341,63,278,"roboczy"
2017-06-05 17:00:00,2017-06-05,17,226,145,81,586,25,262,234,162,169,335,158,177,343,67,276,68,740,351,389,295,70,373,73,300,"roboczy"
2017-06-05 18:00:00,2017-06-05,18,211,155,56,401,23,239,160,126,181,370,187,183,341,104,237,87,555,246,309,277,78,348,69,279,"roboczy"
2017-06-05 19:00:00,2017-06-05,19,183,120,63,302,26,155,159,129,106,395,200,195,283,111,172,101,396,212,184,250,120,261,60,201,"roboczy"
2017-06-05 20:00:00,2017-06-05,20,177,116,61,255,21,129,118,81,89,338,146,192,292,108,184,70,332,179,153,208,88,219,32,187,"roboczy"
2017-06-05 21:00:00,2017-06-05,21,101,63,38,140,18,87,83,70,79,186,67,119,210,70,140,27,272,148,124,140,55,124,16,108,"roboczy"
2017-06-05 22:00:00,2017-06-05,22,56,35,21,101,10,52,39,50,36,77,23,54,112,30,82,4,133,73,60,86,26,71,12,59,"roboczy"
2017-06-05 23:00:00,2017-06-05,23,21,12,9,50,2,43,32,42,31,38,16,22,53,14,39,0,85,56,29,27,8,29,4,25,"roboczy"
2017-06-06 00:00:00,2017-06-06,0,13,9,4,16,1,5,12,7,9,6,0,6,18,9,9,0,37,20,17,17,4,8,2,6,"roboczy"
2017-06-06 01:00:00,2017-06-06,1,1,1,0,2,1,3,7,4,6,1,1,0,8,2,6,0,13,7,6,6,2,5,2,3,"roboczy"
2017-06-06 02:00:00,2017-06-06,2,1,0,1,3,0,1,4,4,4,1,1,0,11,5,6,0,6,4,2,1,0,2,0,2,"roboczy"
2017-06-06 03:00:00,2017-06-06,3,4,2,2,3,2,1,4,3,5,0,0,0,2,0,2,0,4,2,2,5,2,0,0,0,"roboczy"
2017-06-06 04:00:00,2017-06-06,4,4,2,2,3,0,2,13,2,1,4,2,2,4,1,3,1,12,7,5,4,2,5,0,5,"roboczy"
2017-06-06 05:00:00,2017-06-06,5,11,10,1,26,6,10,39,23,9,16,3,13,22,4,18,1,29,12,17,41,20,21,4,17,"roboczy"
2017-06-06 06:00:00,2017-06-06,6,42,31,11,159,17,45,114,59,47,101,38,63,99,17,82,5,139,65,74,133,37,117,26,91,"roboczy"
2017-06-06 07:00:00,2017-06-06,7,119,85,34,453,30,113,194,141,96,169,77,92,186,49,137,11,441,204,237,264,67,333,65,268,"roboczy"
2017-06-06 08:00:00,2017-06-06,8,133,91,42,570,20,198,183,118,164,245,95,150,196,56,140,19,663,316,347,238,40,414,90,324,"roboczy"
2017-06-06 09:00:00,2017-06-06,9,71,40,31,325,8,134,92,83,119,150,60,90,138,45,93,19,461,215,246,164,28,220,42,178,"roboczy"
2017-06-06 10:00:00,2017-06-06,10,62,44,18,189,11,68,61,63,72,109,46,63,73,18,55,12,278,122,156,83,25,134,44,90,"roboczy"
2017-06-06 11:00:00,2017-06-06,11,59,41,18,192,9,66,53,58,75,95,36,59,79,23,56,10,255,109,146,72,28,119,34,85,"roboczy"
2017-06-06 12:00:00,2017-06-06,12,43,25,18,132,11,49,59,55,85,115,52,63,82,27,55,26,258,126,132,92,27,105,28,77,"roboczy"
2017-06-06 13:00:00,2017-06-06,13,46,26,20,138,10,56,65,61,94,108,61,47,93,30,63,14,249,122,127,90,35,117,36,81,"roboczy"
2017-06-06 14:00:00,2017-06-06,14,64,39,25,202,13,90,75,75,88,105,43,62,112,29,83,16,301,156,145,127,45,133,40,93,"roboczy"
2017-06-06 15:00:00,2017-06-06,15,106,69,37,336,21,121,125,118,110,141,50,91,156,38,118,26,372,182,190,180,43,258,48,210,"roboczy"
2017-06-06 16:00:00,2017-06-06,16,94,77,17,378,7,145,149,86,88,167,54,113,153,24,129,13,404,184,220,169,53,239,44,195,"roboczy"
2017-06-06 17:00:00,2017-06-06,17,93,69,24,435,5,194,124,78,110,140,59,81,161,35,126,7,522,247,275,186,48,303,55,248,"roboczy"
2017-06-06 18:00:00,2017-06-06,18,85,53,32,268,9,124,100,86,101,111,50,61,84,13,71,16,333,161,172,153,37,194,36,158,"roboczy"
2017-06-06 19:00:00,2017-06-06,19,55,30,25,146,8,71,68,58,68,97,34,63,65,18,47,9,223,116,107,93,38,110,25,85,"roboczy"
2017-06-06 20:00:00,2017-06-06,20,40,29,11,108,6,53,70,68,36,68,31,37,67,16,51,14,173,98,75,94,34,80,17,63,"roboczy"
2017-06-06 21:00:00,2017-06-06,21,40,27,13,74,7,47,41,26,30,45,22,23,46,9,37,3,131,74,57,51,20,48,5,43,"roboczy"
2017-06-06 22:00:00,2017-06-06,22,19,12,7,49,5,21,30,25,27,23,8,15,37,12,25,0,96,52,44,38,16,26,1,25,"roboczy"
2017-06-06 23:00:00,2017-06-06,23,8,5,3,28,2,15,15,13,17,20,11,9,19,7,12,0,40,25,15,19,4,22,8,14,"roboczy"
2017-06-07 00:00:00,2017-06-07,0,8,2,6,13,1,7,5,4,7,2,2,0,10,4,6,0,23,12,11,4,5,6,2,4,"roboczy"
2017-06-07 01:00:00,2017-06-07,1,2,0,2,4,0,1,2,3,5,1,0,1,6,2,4,5,27,17,10,7,0,6,2,4,"roboczy"
2017-06-07 02:00:00,2017-06-07,2,0,0,0,5,1,1,3,1,2,1,0,1,1,0,1,0,6,4,2,0,1,3,0,3,"roboczy"
2017-06-07 03:00:00,2017-06-07,3,0,0,0,0,1,1,4,4,3,0,0,0,1,1,0,0,3,1,2,2,2,0,0,0,"roboczy"
2017-06-07 04:00:00,2017-06-07,4,3,2,1,6,0,0,6,7,3,3,1,2,2,0,2,0,13,5,8,3,4,3,0,3,"roboczy"
2017-06-07 05:00:00,2017-06-07,5,4,4,0,7,3,3,8,10,7,7,3,4,8,1,7,0,9,2,7,22,4,10,4,6,"roboczy"
2017-06-07 06:00:00,2017-06-07,6,16,13,3,70,2,12,33,20,14,31,12,19,32,5,27,0,43,18,25,40,13,52,17,35,"roboczy"
2017-06-07 07:00:00,2017-06-07,7,52,33,19,245,11,60,92,57,53,68,28,40,70,17,53,4,226,97,129,108,20,189,47,142,"roboczy"
2017-06-07 08:00:00,2017-06-07,8,71,50,21,435,14,127,125,100,119,115,52,63,126,31,95,8,503,233,270,178,26,337,75,262,"roboczy"
2017-06-07 09:00:00,2017-06-07,9,44,24,20,298,6,107,73,59,107,108,51,57,93,35,58,14,386,185,201,132,19,185,41,144,"roboczy"
2017-06-07 10:00:00,2017-06-07,10,45,29,16,167,5,49,73,62,60,82,30,52,52,11,41,3,211,98,113,74,19,93,20,73,"roboczy"
2017-06-07 11:00:00,2017-06-07,11,44,22,22,137,9,41,65,47,51,52,29,23,46,17,29,10,187,83,104,54,26,93,34,59,"roboczy"
2017-06-07 12:00:00,2017-06-07,12,42,21,21,124,20,52,44,61,69,76,32,44,53,16,37,13,202,95,107,64,34,86,24,62,"roboczy"
2017-06-07 13:00:00,2017-06-07,13,42,26,16,141,10,51,64,46,92,89,38,51,82,36,46,14,231,106,125,73,29,109,33,76,"roboczy"
2017-06-07 14:00:00,2017-06-07,14,46,25,21,140,11,75,72,66,89,116,58,58,83,34,49,12,283,133,150,86,31,120,34,86,"roboczy"
2017-06-07 15:00:00,2017-06-07,15,48,27,21,207,18,85,105,90,112,154,63,91,143,34,109,26,304,143,161,154,31,183,38,145,"roboczy"
2017-06-07 16:00:00,2017-06-07,16,116,78,38,416,26,194,134,134,132,225,100,125,173,43,130,35,549,263,286,245,57,290,45,245,"roboczy"
2017-06-07 17:00:00,2017-06-07,17,161,102,59,447,24,226,197,178,157,334,129,205,260,72,188,65,639,290,349,287,101,373,47,326,"roboczy"
2017-06-07 18:00:00,2017-06-07,18,206,128,78,361,31,194,161,142,117,419,168,251,358,107,251,107,498,237,261,303,89,308,57,251,"roboczy"
2017-06-07 19:00:00,2017-06-07,19,198,132,66,298,31,138,116,134,109,456,199,257,387,100,287,95,400,195,205,257,102,287,46,241,"roboczy"
2017-06-07 20:00:00,2017-06-07,20,163,91,72,229,20,133,116,104,101,455,202,253,337,86,251,87,362,193,169,210,68,182,36,146,"roboczy"
2017-06-07 21:00:00,2017-06-07,21,110,71,39,163,12,69,82,80,81,189,84,105,283,89,194,30,300,182,118,123,48,99,12,87,"roboczy"
2017-06-07 22:00:00,2017-06-07,22,75,47,28,79,7,65,55,39,58,112,45,67,161,42,119,5,167,110,57,91,30,67,6,61,"roboczy"
2017-06-07 23:00:00,2017-06-07,23,31,18,13,38,1,34,18,28,20,29,11,18,81,38,43,2,115,71,44,34,9,24,2,22,"roboczy"
2017-06-08 00:00:00,2017-06-08,0,9,4,5,25,1,20,14,9,21,23,11,12,37,13,24,0,78,41,37,15,4,9,0,9,"roboczy"
2017-06-08 01:00:00,2017-06-08,1,5,2,3,10,0,4,12,10,9,8,1,7,9,5,4,0,26,10,16,8,0,2,0,2,"roboczy"
2017-06-08 02:00:00,2017-06-08,2,0,0,0,4,0,1,1,1,6,0,0,0,3,2,1,0,18,15,3,6,0,5,1,4,"roboczy"
2017-06-08 03:00:00,2017-06-08,3,4,1,3,2,1,0,4,3,1,3,2,1,1,0,1,0,15,6,9,5,2,2,0,2,"roboczy"
2017-06-08 04:00:00,2017-06-08,4,6,4,2,6,2,2,7,5,3,4,2,2,5,1,4,5,16,11,5,10,3,5,1,4,"roboczy"
2017-06-08 05:00:00,2017-06-08,5,9,8,1,15,6,8,33,25,11,28,6,22,27,9,18,1,39,25,14,45,13,18,3,15,"roboczy"
2017-06-08 06:00:00,2017-06-08,6,44,30,14,145,18,37,103,52,25,96,35,61,87,16,71,3,122,59,63,119,36,100,22,78,"roboczy"
2017-06-08 07:00:00,2017-06-08,7,102,76,26,439,28,122,188,124,110,188,82,106,173,46,127,7,431,188,243,239,64,305,55,250,"roboczy"
2017-06-08 08:00:00,2017-06-08,8,124,93,31,547,20,184,164,130,164,184,73,111,174,60,114,19,641,297,344,239,41,383,70,313,"roboczy"
2017-06-08 09:00:00,2017-06-08,9,69,42,27,348,12,139,98,77,118,148,59,89,119,28,91,14,447,198,249,155,29,210,35,175,"roboczy"
2017-06-08 10:00:00,2017-06-08,10,59,41,18,191,10,77,64,69,88,110,44,66,58,22,36,20,237,96,141,99,40,117,30,87,"roboczy"
2017-06-08 11:00:00,2017-06-08,11,61,37,24,162,9,74,81,63,89,116,60,56,97,34,63,25,247,101,146,77,37,110,38,72,"roboczy"
2017-06-08 12:00:00,2017-06-08,12,65,35,30,146,14,38,60,63,89,135,66,69,80,30,50,14,275,131,144,88,47,121,44,77,"roboczy"
2017-06-08 13:00:00,2017-06-08,13,67,42,25,189,7,80,84,74,87,108,59,49,111,37,74,26,272,120,152,115,38,136,43,93,"roboczy"
2017-06-08 14:00:00,2017-06-08,14,71,42,29,201,11,72,85,90,91,152,63,89,115,50,65,41,286,137,149,132,47,182,51,131,"roboczy"
2017-06-08 15:00:00,2017-06-08,15,105,69,36,281,23,128,123,134,125,197,81,116,222,62,160,35,411,211,200,206,60,243,48,195,"roboczy"
2017-06-08 16:00:00,2017-06-08,16,147,100,47,534,29,236,189,147,185,342,141,201,239,63,176,34,666,305,361,312,104,347,68,279,"roboczy"
2017-06-08 17:00:00,2017-06-08,17,188,116,72,585,24,270,247,189,180,324,143,181,361,86,275,70,723,355,368,308,83,454,66,388,"roboczy"
2017-06-08 18:00:00,2017-06-08,18,139,83,56,415,22,200,178,156,136,373,155,218,329,100,229,78,553,256,297,279,103,359,68,291,"roboczy"
2017-06-08 19:00:00,2017-06-08,19,171,100,71,256,20,127,136,120,65,329,151,178,305,98,207,63,383,189,194,232,87,213,40,173,"roboczy"
2017-06-08 20:00:00,2017-06-08,20,139,85,54,213,24,120,124,92,89,262,122,140,278,82,196,95,323,170,153,200,97,169,33,136,"roboczy"
2017-06-08 21:00:00,2017-06-08,21,81,62,19,152,24,73,83,74,65,208,105,103,222,57,165,29,241,137,104,140,54,97,10,87,"roboczy"
2017-06-08 22:00:00,2017-06-08,22,63,46,17,91,3,60,64,49,53,86,30,56,143,49,94,11,198,125,73,87,19,52,6,46,"roboczy"
2017-06-08 23:00:00,2017-06-08,23,22,17,5,42,2,28,22,28,37,40,16,24,67,23,44,2,94,50,44,41,11,33,6,27,"roboczy"
2017-06-09 00:00:00,2017-06-09,0,9,6,3,23,3,15,14,10,18,16,6,10,33,13,20,0,39,28,11,21,5,13,1,12,"roboczy"
2017-06-09 01:00:00,2017-06-09,1,5,2,3,14,1,4,8,2,13,6,2,4,13,4,9,0,37,23,14,7,3,14,1,13,"roboczy"
2017-06-09 02:00:00,2017-06-09,2,0,0,0,6,0,2,2,4,4,2,0,2,7,5,2,0,15,7,8,8,0,2,0,2,"roboczy"
2017-06-09 03:00:00,2017-06-09,3,2,1,1,6,0,0,3,3,6,2,0,2,5,3,2,0,12,7,5,5,3,1,0,1,"roboczy"
2017-06-09 04:00:00,2017-06-09,4,4,4,0,4,1,2,5,11,5,4,1,3,3,2,1,1,9,6,3,3,2,2,2,0,"roboczy"
2017-06-09 05:00:00,2017-06-09,5,15,10,5,24,5,5,30,17,10,19,6,13,28,2,26,4,30,18,12,38,20,20,4,16,"roboczy"
2017-06-09 06:00:00,2017-06-09,6,35,24,11,135,14,27,107,49,31,79,36,43,84,11,73,3,124,64,60,100,35,103,18,85,"roboczy"
2017-06-09 07:00:00,2017-06-09,7,94,70,24,357,21,98,194,140,76,179,78,101,169,39,130,18,381,183,198,219,61,247,57,190,"roboczy"
2017-06-09 08:00:00,2017-06-09,8,95,71,24,519,17,172,141,97,129,168,63,105,172,48,124,13,574,266,308,222,40,362,80,282,"roboczy"
2017-06-09 09:00:00,2017-06-09,9,72,39,33,255,11,109,89,67,89,94,31,63,114,31,83,11,400,217,183,129,16,189,42,147,"roboczy"
2017-06-09 10:00:00,2017-06-09,10,53,34,19,221,7,55,68,70,59,95,43,52,63,19,44,14,232,102,130,72,22,113,28,85,"roboczy"
2017-06-09 11:00:00,2017-06-09,11,52,30,22,174,4,66,67,64,53,109,53,56,78,27,51,30,237,103,134,81,29,103,33,70,"roboczy"
2017-06-09 12:00:00,2017-06-09,12,56,35,21,150,11,59,58,65,97,122,62,60,93,29,64,27,236,119,117,99,44,115,33,82,"roboczy"
2017-06-09 13:00:00,2017-06-09,13,59,42,17,189,8,86,69,77,88,134,71,63,96,29,67,22,269,126,143,109,39,125,34,91,"roboczy"
2017-06-09 14:00:00,2017-06-09,14,83,57,26,180,14,78,105,98,82,152,68,84,134,50,84,25,301,138,163,137,48,135,24,111,"roboczy"
2017-06-09 15:00:00,2017-06-09,15,92,67,25,295,18,116,137,131,107,229,106,123,212,54,158,45,435,197,238,245,56,237,49,188,"roboczy"
2017-06-09 16:00:00,2017-06-09,16,146,98,48,506,24,250,200,165,171,345,155,190,296,71,225,41,627,286,341,337,84,342,65,277,"roboczy"
2017-06-09 17:00:00,2017-06-09,17,173,112,61,488,27,238,207,183,131,436,200,236,307,70,237,73,705,317,388,314,91,419,71,348,"roboczy"
2017-06-09 18:00:00,2017-06-09,18,206,140,66,294,23,158,180,176,112,440,192,248,361,101,260,97,506,250,256,260,102,269,55,214,"roboczy"
2017-06-09 19:00:00,2017-06-09,19,187,110,77,253,47,154,145,108,108,473,205,268,390,107,283,134,402,213,189,308,117,242,57,185,"roboczy"
2017-06-09 20:00:00,2017-06-09,20,156,95,61,213,23,125,124,100,88,424,194,230,405,86,319,107,360,166,194,233,90,218,38,180,"roboczy"
2017-06-09 21:00:00,2017-06-09,21,124,86,38,191,19,75,80,87,89,327,149,178,321,58,263,53,316,163,153,174,55,135,8,127,"roboczy"
2017-06-09 22:00:00,2017-06-09,22,54,40,14,101,7,51,59,61,75,188,65,123,220,29,191,6,251,130,121,90,41,82,18,64,"roboczy"
2017-06-09 23:00:00,2017-06-09,23,40,23,17,86,2,22,61,27,61,92,35,57,163,24,139,6,163,90,73,59,5,63,10,53,"roboczy"
2017-06-10 00:00:00,2017-06-10,0,21,12,9,32,1,18,25,29,20,39,12,27,113,20,93,0,93,59,34,35,3,21,6,15,"weekend"
2017-06-10 01:00:00,2017-06-10,1,14,8,6,28,2,10,25,13,12,17,5,12,98,15,83,4,62,41,21,13,7,17,4,13,"weekend"
2017-06-10 02:00:00,2017-06-10,2,6,2,4,13,4,7,11,5,6,12,2,10,36,7,29,2,41,32,9,8,1,9,5,4,"weekend"
2017-06-10 03:00:00,2017-06-10,3,4,2,2,2,1,0,12,8,6,4,3,1,13,2,11,4,19,13,6,2,3,6,2,4,"weekend"
2017-06-10 04:00:00,2017-06-10,4,3,3,0,2,0,2,7,8,4,5,2,3,12,3,9,9,20,11,9,5,3,1,0,1,"weekend"
2017-06-10 05:00:00,2017-06-10,5,5,2,3,11,2,5,11,5,4,5,1,4,14,4,10,8,15,10,5,20,10,14,5,9,"weekend"
2017-06-10 06:00:00,2017-06-10,6,13,7,6,26,6,14,29,14,13,29,19,10,26,9,17,5,41,12,29,27,13,24,5,19,"weekend"
2017-06-10 07:00:00,2017-06-10,7,27,14,13,43,5,34,39,32,17,54,18,36,30,10,20,6,75,35,40,53,14,41,5,36,"weekend"
2017-06-10 08:00:00,2017-06-10,8,34,23,11,101,15,35,53,44,24,84,30,54,73,21,52,4,112,48,64,75,26,70,19,51,"weekend"
2017-06-10 09:00:00,2017-06-10,9,61,39,22,110,8,69,68,81,48,165,65,100,116,36,80,26,146,60,86,100,34,106,22,84,"weekend"
2017-06-10 10:00:00,2017-06-10,10,76,48,28,157,16,114,86,79,53,249,127,122,135,33,102,38,206,80,126,113,45,146,24,122,"weekend"
2017-06-10 11:00:00,2017-06-10,11,123,85,38,245,29,138,121,94,125,370,166,204,245,94,151,76,255,113,142,191,78,180,40,140,"weekend"
2017-06-10 12:00:00,2017-06-10,12,124,79,45,205,25,177,99,118,151,451,205,246,350,158,192,171,350,176,174,256,91,168,36,132,"weekend"
2017-06-10 13:00:00,2017-06-10,13,163,89,74,235,27,166,126,152,140,580,275,305,406,165,241,132,349,158,191,301,75,202,32,170,"weekend"
2017-06-10 14:00:00,2017-06-10,14,141,96,45,236,26,164,141,160,154,518,237,281,459,198,261,132,478,225,253,294,83,196,33,163,"weekend"
2017-06-10 15:00:00,2017-06-10,15,144,90,54,259,30,190,136,107,134,482,216,266,472,143,329,128,408,203,205,292,71,214,29,185,"weekend"
2017-06-10 16:00:00,2017-06-10,16,149,112,37,262,34,178,134,114,124,503,223,280,395,174,221,90,371,200,171,239,67,180,25,155,"weekend"
2017-06-10 17:00:00,2017-06-10,17,145,93,52,261,23,153,122,137,93,384,158,226,348,126,222,84,384,220,164,252,65,214,31,183,"weekend"
2017-06-10 18:00:00,2017-06-10,18,140,100,40,186,14,121,135,123,102,336,152,184,302,84,218,55,352,197,155,202,78,159,33,126,"weekend"
2017-06-10 19:00:00,2017-06-10,19,115,73,42,159,20,100,127,117,88,248,114,134,245,78,167,41,274,152,122,182,53,148,27,121,"weekend"
2017-06-10 20:00:00,2017-06-10,20,74,46,28,121,5,67,80,70,66,163,67,96,191,60,131,20,210,99,111,129,24,119,23,96,"weekend"
2017-06-10 21:00:00,2017-06-10,21,60,36,24,72,5,34,66,45,38,67,18,49,87,14,73,10,155,93,62,60,11,52,10,42,"weekend"
2017-06-10 22:00:00,2017-06-10,22,30,23,7,67,3,33,28,22,53,55,7,48,59,10,49,2,114,77,37,58,16,21,4,17,"weekend"
2017-06-10 23:00:00,2017-06-10,23,23,13,10,41,1,16,38,49,37,32,14,18,55,4,51,1,116,64,52,34,3,29,3,26,"weekend"
2017-06-11 00:00:00,2017-06-11,0,8,5,3,42,2,11,23,27,12,18,3,15,40,1,39,0,71,49,22,27,9,18,6,12,"weekend"
2017-06-11 01:00:00,2017-06-11,1,10,6,4,12,1,5,14,10,7,17,10,7,40,6,34,4,53,39,14,16,7,9,2,7,"weekend"
2017-06-11 02:00:00,2017-06-11,2,6,4,2,14,0,9,1,2,5,12,5,7,23,2,21,2,31,21,10,7,4,11,4,7,"weekend"
2017-06-11 03:00:00,2017-06-11,3,1,1,0,8,0,8,6,2,5,0,0,0,2,1,1,6,27,17,10,3,1,5,1,4,"weekend"
2017-06-11 04:00:00,2017-06-11,4,2,1,1,7,0,0,4,7,2,7,3,4,6,3,3,5,18,16,2,2,2,5,1,4,"weekend"
2017-06-11 05:00:00,2017-06-11,5,7,6,1,4,2,7,11,7,3,8,4,4,5,2,3,4,16,11,5,8,1,6,1,5,"weekend"
2017-06-11 06:00:00,2017-06-11,6,6,1,5,23,0,7,13,6,10,18,5,13,16,2,14,3,20,8,12,17,4,22,6,16,"weekend"
2017-06-11 07:00:00,2017-06-11,7,14,8,6,24,7,2,21,10,9,28,16,12,21,5,16,4,31,12,19,30,7,19,4,15,"weekend"
2017-06-11 08:00:00,2017-06-11,8,23,12,11,31,4,32,34,21,22,74,27,47,61,27,34,10,52,25,27,48,13,46,10,36,"weekend"
2017-06-11 09:00:00,2017-06-11,9,51,30,21,75,5,48,49,51,27,115,37,78,79,30,49,30,99,38,61,97,37,61,9,52,"weekend"
2017-06-11 10:00:00,2017-06-11,10,68,43,25,156,8,72,66,62,55,280,137,143,185,66,119,74,174,81,93,135,50,122,20,102,"weekend"
2017-06-11 11:00:00,2017-06-11,11,141,90,51,252,18,132,115,87,60,509,226,283,311,143,168,128,228,82,146,251,71,182,21,161,"weekend"
2017-06-11 12:00:00,2017-06-11,12,194,135,59,308,37,179,173,140,91,679,318,361,486,211,275,192,374,134,240,346,98,271,31,240,"weekend"
2017-06-11 13:00:00,2017-06-11,13,234,152,82,383,39,258,176,170,130,937,407,530,713,290,423,244,426,202,224,453,106,248,40,208,"weekend"
2017-06-11 14:00:00,2017-06-11,14,299,186,113,422,58,222,186,182,136,936,433,503,679,247,432,228,476,193,283,465,134,296,51,245,"weekend"
2017-06-11 15:00:00,2017-06-11,15,202,137,65,370,28,247,194,159,128,946,420,526,668,239,429,176,462,228,234,420,123,305,50,255,"weekend"
2017-06-11 16:00:00,2017-06-11,16,252,149,103,390,36,221,202,168,124,862,344,518,647,236,411,205,481,236,245,445,130,308,50,258,"weekend"
2017-06-11 17:00:00,2017-06-11,17,242,173,69,385,39,245,173,154,154,877,397,480,699,189,510,180,527,322,205,493,133,314,52,262,"weekend"
2017-06-11 18:00:00,2017-06-11,18,216,143,73,367,45,233,225,199,116,730,314,416,584,183,401,168,478,270,208,420,157,340,50,290,"weekend"
2017-06-11 19:00:00,2017-06-11,19,177,120,57,344,44,205,217,160,107,605,276,329,592,158,434,143,412,248,164,378,124,267,41,226,"weekend"
2017-06-11 20:00:00,2017-06-11,20,165,126,39,222,30,148,144,133,126,434,181,253,416,131,285,109,375,230,145,272,108,200,31,169,"weekend"
2017-06-11 21:00:00,2017-06-11,21,101,61,40,124,14,108,120,101,79,217,80,137,224,71,153,50,251,168,83,169,56,109,13,96,"weekend"
2017-06-11 22:00:00,2017-06-11,22,28,19,9,95,10,58,44,73,64,108,54,54,108,40,68,0,205,140,65,58,29,50,6,44,"weekend"
2017-06-11 23:00:00,2017-06-11,23,18,11,7,36,2,23,21,30,35,47,16,31,48,14,34,0,111,78,33,49,12,18,1,17,"weekend"
2017-06-12 00:00:00,2017-06-12,0,13,12,1,19,3,15,14,18,13,18,14,4,18,6,12,0,39,23,16,28,5,8,1,7,"roboczy"
2017-06-12 01:00:00,2017-06-12,1,1,1,0,2,0,3,5,2,4,5,1,4,15,1,14,0,19,12,7,8,1,3,1,2,"roboczy"
2017-06-12 02:00:00,2017-06-12,2,2,2,0,7,3,2,2,3,4,1,0,1,4,1,3,0,13,7,6,3,5,4,1,3,"roboczy"
2017-06-12 03:00:00,2017-06-12,3,1,1,0,0,0,5,3,5,10,0,0,0,0,0,0,0,15,13,2,1,1,0,0,0,"roboczy"
2017-06-12 04:00:00,2017-06-12,4,2,2,0,3,1,1,5,6,2,5,3,2,2,1,1,3,9,5,4,3,3,6,2,4,"roboczy"
2017-06-12 05:00:00,2017-06-12,5,13,9,4,16,5,6,23,21,11,15,8,7,18,5,13,5,18,8,10,21,17,19,3,16,"roboczy"
2017-06-12 06:00:00,2017-06-12,6,33,25,8,111,8,26,96,45,18,72,28,44,73,14,59,6,118,53,65,93,18,82,19,63,"roboczy"
2017-06-12 07:00:00,2017-06-12,7,84,60,24,338,26,99,172,106,83,142,53,89,126,29,97,18,342,156,186,193,56,220,50,170,"roboczy"
2017-06-12 08:00:00,2017-06-12,8,87,57,30,445,16,135,126,90,129,131,48,83,143,41,102,14,520,234,286,184,27,350,69,281,"roboczy"
2017-06-12 09:00:00,2017-06-12,9,45,27,18,234,6,92,56,64,80,87,40,47,66,14,52,7,290,131,159,87,12,171,28,143,"roboczy"
2017-06-12 10:00:00,2017-06-12,10,42,25,17,121,7,39,40,45,60,61,33,28,40,10,30,2,180,71,109,62,18,89,15,74,"roboczy"
2017-06-12 11:00:00,2017-06-12,11,36,14,22,110,4,33,50,63,63,66,32,34,47,19,28,3,159,70,89,60,22,67,19,48,"roboczy"
2017-06-12 12:00:00,2017-06-12,12,50,35,15,125,5,24,38,36,73,57,33,24,63,17,46,3,161,71,90,91,21,67,23,44,"roboczy"
2017-06-12 13:00:00,2017-06-12,13,49,30,19,109,8,47,52,71,72,65,28,37,57,19,38,18,171,93,78,53,34,80,25,55,"roboczy"
2017-06-12 14:00:00,2017-06-12,14,63,39,24,142,14,49,66,79,80,66,29,37,81,22,59,13,213,87,126,70,28,95,29,66,"roboczy"
2017-06-12 15:00:00,2017-06-12,15,77,42,35,213,15,111,110,124,100,114,36,78,121,26,95,29,295,137,158,170,39,173,24,149,"roboczy"
2017-06-12 16:00:00,2017-06-12,16,77,57,20,302,7,126,124,104,109,117,43,74,120,28,92,11,361,171,190,177,34,227,38,189,"roboczy"
2017-06-12 17:00:00,2017-06-12,17,81,63,18,342,11,148,129,106,97,115,32,83,123,33,90,12,425,206,219,162,34,242,46,196,"roboczy"
2017-06-12 18:00:00,2017-06-12,18,112,76,36,266,12,118,116,120,97,151,67,84,150,47,103,11,390,187,203,153,64,190,39,151,"roboczy"
2017-06-12 19:00:00,2017-06-12,19,128,85,43,211,14,90,114,104,88,211,101,110,172,69,103,25,269,123,146,145,74,193,35,158,"roboczy"
2017-06-12 20:00:00,2017-06-12,20,48,27,21,92,4,42,45,43,24,79,33,46,69,14,55,11,130,71,59,81,17,72,7,65,"roboczy"
2017-06-12 21:00:00,2017-06-12,21,55,32,23,76,10,36,42,36,41,69,28,41,70,18,52,4,118,65,53,65,31,89,11,78,"roboczy"
2017-06-12 22:00:00,2017-06-12,22,21,13,8,61,4,36,30,28,35,34,10,24,36,10,26,0,91,51,40,44,18,38,6,32,"roboczy"
2017-06-12 23:00:00,2017-06-12,23,10,10,0,21,3,11,23,18,13,14,3,11,26,17,9,1,46,29,17,20,5,28,3,25,"roboczy"
